ngram,naive.pmi,true.pmi,dp.true.pmi,norm_dp_true_pmi,ngram_size,naive.pmi.rank,dp.true.pmi.rank,norm_dp_true_pmi_rank,adv_pmi_rank_drop,norm_adv_pmi_rank_drop,norm_pmi_rank_rel
CCTCCC,5.3465708705568895,1.51780008840146,2.8491459183724803,2.1030761926846298,6,71560,63232,47294,-8328,-15938,1
GGGAGG,5.334065803293691,1.39903757069026,2.83572710993313,2.0930044199590903,6,71843,63382,47961,-8461,-15421,2
GTGTGT,4.51933452554044,1.1779667569918502,2.7706521617665802,2.0429315507573103,6,92138,64077,51426,-28061,-12651,3
CCCAGC,5.24813927399553,1.36485927670872,2.7513667564900297,2.02684224580676,6,73910,64321,52688,-9589,-11633,4
GCTGGG,5.24109224547785,1.1739143710009399,2.74688998113128,2.0236311574507,6,74109,64373,52931,-9736,-11442,5
ACACAC,4.49545411242483,1.07274696408934,2.7422790883809602,2.02044725569458,6,92566,64439,53225,-28127,-11214,6
AAAAAA,5.05323335502994,1.21949848731534,2.6334331212516804,2.0015550057306,6,79096,66080,54839,-13016,-11241,7
TTTTTT,5.046783791408361,1.2150901828275902,2.62213825476908,1.99325300724392,6,79256,66306,55490,-12950,-10816,8
CCAGGC,5.162573508165639,1.34485932269796,2.6974001211633998,1.98369237704909,6,76151,65053,56373,-11098,-8680,9
GCCTGG,5.15956559023218,1.20511864481822,2.6958744201709597,1.9826409315159,6,76223,65081,56482,-11142,-8599,10
GCCTCC,5.145117252627849,1.20210122191753,2.68110215954271,1.9710083932278502,6,76564,65299,57599,-11265,-7700,11
GGAGGC,5.13933476381733,1.38678912853798,2.67448529983901,1.96607719377426,6,76717,65410,58076,-11307,-7334,12
CAGCCT,5.06911852842702,1.42954667494953,2.63751438111804,1.95098491822371,6,78677,66000,59618,-12677,-6382,13
AGGCTG,5.064879900531849,1.22336068964384,2.63436378944079,1.9486613392161598,6,78804,66063,59838,-12741,-6225,14
TATATA,3.7905651651527403,1.01297309248847,2.5680003500541897,1.9088070545555902,6,99038,67369,63991,-31669,-3378,15
CCCAGG,5.213885606438071,1.2556511339298602,2.51962510184385,1.8549106645850302,6,74858,68377,64956,-6481,-3421,16
CCTGGG,5.20665591055683,1.13947803607993,2.5146417360976203,1.8511475962530402,6,75074,68490,65032,-6584,-3458,17
TCCCAG,4.9258224412892,0.8471814955284721,2.4924075653842204,1.8383629054407098,6,82702,68996,65279,-13706,-3717,18
GCCCAG,4.96470159308267,0.8860606473219459,2.4995282060804302,1.83058683869287,6,81603,68841,65457,-12762,-3384,19
CTGGGC,4.96082681960019,1.3748456383445502,2.49713564953896,1.8288676959928,6,81732,68883,65501,-12849,-3382,20
CTGGGA,4.90987632500501,1.2755791064975,2.47638207881704,1.82611623265122,6,83143,69390,65560,-13753,-3830,21
CCAGCC,5.14041985817341,1.2882149636461202,2.4774345610585202,1.8210114542929199,6,76688,69356,65669,-7332,-3687,22
GGCTGG,5.133721066872179,1.25277807652904,2.4725419097222296,1.81750645387929,6,76901,69487,65755,-7414,-3732,23
GCCAGG,4.96481354130821,1.0065790688,2.46836494682664,1.80785364593306,6,81597,69589,65978,-12008,-3611,24
CCTGGC,4.96084259692625,1.3800566701484098,2.4663164095557497,1.80621224942888,6,81730,69651,66015,-12079,-3636,25
CTGCCT,4.84540611438267,1.2173546975102,2.44655939149404,1.8016894405645503,6,84846,70155,66127,-14691,-4028,26
AGGCAG,4.84662058132992,1.11419363530643,2.44545727060711,1.80090010605706,6,84809,70189,66145,-14620,-4044,27
GTGAGC,4.32109212562406,1.1318752980065,2.4163330703093098,1.75984384906566,6,95111,71010,67210,-24101,-3800,28
GCTCAC,4.31981835378572,1.04101837855303,2.41515979766072,1.758768185622,6,95128,71039,67242,-24089,-3797,29
GAGAGA,4.36945436420008,0.929018980245248,2.3264854927634904,1.70990261577797,6,94531,73832,68726,-20699,-5106,30
CTCCTG,4.941047482413429,1.24386245878839,2.3138777551268,1.7072937562593,6,82310,74256,68820,-8054,-5436,31
TCTCTC,4.36082162496702,0.991324379714271,2.32253751520244,1.7067277284398001,6,94642,73964,68834,-20678,-5130,32
ACAGGC,4.40844494690422,0.5907307614365339,2.33822604584873,1.7060325918062902,6,93943,73415,68853,-20528,-4562,33
CAGGAG,4.939075148169571,1.23820691068708,2.30882471985477,1.70347660831521,6,82356,74427,68969,-7929,-5458,34
GCCTGT,4.401343871651259,1.05367831118413,2.33374435254712,1.70268582705029,6,94044,73576,68991,-20468,-4585,35
CCTCAG,4.74123420165378,1.1016623481763002,2.30781932574881,1.69578932972545,6,87347,74465,69231,-12882,-5234,36
CTGAGG,4.73216248747574,1.10711903703761,2.29866824128777,1.68890279323365,6,87562,74799,69463,-12763,-5336,37
CCACCA,4.6017960613648,1.0395455623407601,2.30216611969341,1.68653544384797,6,90534,74672,69562,-15862,-5110,38
TGGTGG,4.5944590123068,0.920156597088978,2.2988604118286,1.68434695791639,6,90675,74793,69647,-15882,-5146,39
CCTGCC,4.97889259014837,1.2165391963268102,2.28655449266523,1.67512488343163,6,81182,75254,69960,-5928,-5294,40
GGCAGG,4.9689205715005,1.20436618076251,2.2749839899302002,1.66644192880443,6,81479,75698,70273,-5781,-5425,41
CAGTGG,4.56826462826509,0.8966995617936758,2.27041969765188,1.6624199402488997,6,91194,75870,70420,-15324,-5450,42
CCACTG,4.56607769949853,0.90863464679912,2.26869408796215,1.6609227401007198,6,91237,75932,70477,-15305,-5455,43
CAGCAC,4.37366146116172,0.908918031057441,2.27184342960298,1.6562631123416103,6,94466,75826,70646,-18640,-5180,44
CTCAGC,4.687300548341059,1.15366979416619,2.25569640103208,1.65563012349403,6,88618,76456,70671,-12162,-5785,45
ACACAG,4.13520481062733,0.655417217496908,2.2621284854059502,1.65427034374358,6,96993,76196,70709,-20797,-5487,46
GTGCTG,4.3627923414801195,0.8893439327182829,2.26468172809064,1.6509914516576,6,94618,76100,70845,-18518,-5255,47
ACAGAG,4.44622439683368,0.8226816933660179,2.24220366194498,1.65049154125136,6,93387,77000,70864,-16387,-6136,48
GCTGAG,4.67520893208593,1.1205595712852099,2.24469282099487,1.6472895724928,6,88889,76907,70976,-11982,-5931,49
CTGTGT,4.119604250169931,0.737271653581976,2.25060839493416,1.6456409933578402,6,97110,76648,71035,-20462,-5613,50
CTCCCA,4.86246898721354,1.2197607111951498,2.2330529297918997,1.6448742032456698,6,84370,77387,71058,-6983,-6329,51
CCTCCT,4.669191911659509,1.07912281662732,2.23693532967162,1.6412482372023702,6,89025,77221,71218,-11804,-6003,52
TGGGAG,4.85121869661543,1.02856493312775,2.22321459843564,1.6375461856723001,6,84672,77801,71364,-6871,-6437,53
AAAATA,4.20518987864533,1.02966401038711,2.1844681177603,1.6362157270413602,6,96372,79389,71421,-16983,-7968,54
CACTGC,4.6570755460729005,1.14397883275473,2.22547139876392,1.6324122325420298,6,89286,77687,71570,-11599,-6117,55
AGGAGG,4.659418447436599,0.724390214833173,2.22476590733154,1.6321157068503898,6,89236,77729,71579,-11507,-6150,56
GCAGTG,4.6543269558880995,1.13869651336357,2.2238108447970397,1.63125127452259,6,89351,77770,71627,-11581,-6143,57
CCACCC,4.578088611175549,0.9849048565836079,2.24604772372798,1.6309980976821599,6,91004,76843,71640,-14161,-5203,58
ATATAT,3.8854211104985805,1.1153760573125702,2.1886459602733304,1.629779540582,6,98606,79225,71698,-19381,-7527,59
TATTTT,4.19857319517699,0.8648354171672371,2.17462123238462,1.62894260849241,6,96425,79809,71733,-16616,-8076,60
GGGTGG,4.5638936640779,0.8895912488600749,2.23396171071244,1.6222002318576003,6,91278,77340,72019,-13938,-5321,61
CTGCAC,4.29483700853262,0.8416140150333521,2.2257764013942203,1.61996492621719,6,95450,77676,72111,-17774,-5565,62
GCTGGA,4.481373573739809,1.0450631129788899,2.2148562203552298,1.61873053175944,6,92825,78118,72166,-14707,-5952,63
TCTCCT,4.40347294294194,0.813403847909751,2.2007867821639704,1.6186851641275701,6,94019,78719,72168,-15300,-6551,64
AGGAGA,4.40647050242176,0.975395022276533,2.19950287327869,1.61781046019391,6,93970,78776,72204,-15194,-6572,65
TCCAGC,4.47887552876091,0.595595531474107,2.2116734324653198,1.61616325409983,6,92855,78248,72267,-14607,-5981,66
GTGCAG,4.28555582927266,0.8102933448172129,2.21679801625144,1.61325630947007,6,95559,78042,72389,-17517,-5653,67
ACCCAG,4.47307003746004,0.39442909169931,2.2050392262919,1.6110274871323502,6,92953,78524,72492,-14429,-6032,68
AAAAAT,4.31703834432929,0.977995175131817,2.13824647173536,1.6048392241812,6,95154,81466,72787,-13688,-8679,69
CTCTGT,4.38261569455485,1.10148275771691,2.18237263553458,1.6045241479842298,6,94323,79474,72804,-14849,-6670,70
CTGGGT,4.45910069996763,1.0895580509834,2.1940131937747602,1.6028155772961399,6,93197,79006,72884,-14191,-6122,71
ATTTTT,4.31117257739654,0.47947896881577096,2.12915050289527,1.5981327531687701,6,95244,81846,73117,-13398,-8729,72
TTTCTT,4.42943195287568,1.1257488416867198,2.13357355852798,1.5937860334971399,6,93644,81665,73305,-11979,-8360,73
CAGTGA,4.23909852882929,0.872833129904722,2.16893850917806,1.5897846402356899,6,96035,80053,73511,-15982,-6542,74
TCACTG,4.23522847087169,0.763588720213413,2.16741528054522,1.5885482443716499,6,96073,80133,73573,-15940,-6560,75
TCCTGC,4.407533068056661,0.817430032255718,2.17308839618143,1.58560944395843,6,93955,79880,73720,-14075,-6160,76
CCACAC,4.12183538419884,0.699128235863341,2.18474898269803,1.58380456370835,6,97088,79379,73817,-17709,-5562,77
GAGCCA,4.4329520108767495,0.9544346509398821,2.16418832735716,1.57988847106193,6,93596,80274,74007,-13322,-6267,78
GCAGGA,4.40181722132953,0.8185982832514129,2.1646526683131997,1.5792364743275702,6,94035,80245,74041,-13790,-6204,79
TGGCTC,4.42582480387057,0.942444046267415,2.1608690377099897,1.57739432887016,6,93693,80419,74115,-13274,-6304,80
CACCAC,4.45909756325495,1.0409411585464001,2.15946762158356,1.5771817000046102,6,93198,80484,74118,-12714,-6366,81
CCCCAC,4.50682146551515,1.0120486083956601,2.17478057806759,1.5767175288114699,6,92360,79801,74136,-12559,-5665,82
AAGAAA,4.40559624180274,0.914400261779051,2.11140646213836,1.57622390527071,6,93988,82676,74157,-11312,-8519,83
CCAGGA,4.58685795856211,1.00363902048399,2.15188149543313,1.5760878450659799,6,90827,80826,74162,-10001,-6664,84
GAGGCC,4.6644426953453895,1.0457707697065601,2.1657800789609096,1.5759653635503403,6,89137,80208,74169,-8929,-6039,85
CTGCCC,4.63106175798591,0.942685449718598,2.1670466649007603,1.57565600487769,6,89897,80154,74179,-9743,-5975,86
GTGGTG,4.45098297211551,1.02683985776131,2.1553843716373,1.5743953823271497,6,93327,80675,74245,-12652,-6430,87
AGACAG,4.34703459097258,0.849064773358137,2.1430138560838796,1.5742517777357,6,94785,81248,74254,-13537,-6994,88
TCCTGG,4.58087964781618,0.626432702402216,2.1489469888522197,1.5739070851812398,6,90950,80966,74268,-9984,-6698,89
CCACCT,4.42302443884371,0.8901655756466129,2.1561519215926697,1.5736179246772,6,93734,80632,74280,-13102,-6352,90
GTGTGG,4.10299409325476,0.740319975132614,2.16915379084639,1.57232336538959,6,97251,80044,74342,-17207,-5702,91
AGGTGG,4.42006058765796,0.7457581724401371,2.15381478754801,1.5721123162303798,6,93769,80743,74353,-13026,-6390,92
TAAAAA,4.12212065204122,0.28838578432661305,2.10139889115619,1.5716017551258998,6,97083,83128,74382,-13955,-8746,93
GGGCAG,4.62034605378315,0.887919107759659,2.15549658980484,1.5670279338002802,6,90142,80665,74614,-9477,-6051,94
GTGGGG,4.4911224287358396,0.852788535751847,2.1611904753703897,1.56679060289592,6,92657,80403,74622,-12254,-5781,95
CTGCAG,4.53524851873533,0.77109247575552,2.1352435019296,1.5622715863438899,6,91874,81583,74846,-10291,-6737,96
TTTTTA,4.10668289340721,0.932443284280723,2.08273093061484,1.55748620295946,6,97219,84067,75105,-13152,-8962,97
TTTTGT,4.21916167100004,0.934753423291054,2.09014842942343,1.55524645500345,6,96231,83666,75213,-12565,-8453,98
GAGGCT,4.55711735369672,1.00361379825441,2.12362310750875,1.5545664246570803,6,91425,82128,75240,-9297,-6888,99
AGCCTC,4.556807993701191,0.8181719009475921,2.12339311779622,1.5542410066990802,6,91429,82147,75256,-9282,-6891,100
TCTCAG,4.3198328286465495,0.7286521889230729,2.11598837395149,1.55361057164684,6,95127,82462,75292,-12665,-7170,101
TAAAAT,3.8667837134831102,0.527740544285638,2.08707031378242,1.55351675261386,6,98695,83818,75296,-14877,-8522,102
CCCGCC,4.000013058653391,0.475822631456296,2.18201614305718,1.5485342646011697,6,97942,79493,75616,-18449,-3877,103
ATTTTA,3.85935617869487,0.7162486718733071,2.07802767804051,1.5467151926559999,6,98739,84310,75725,-14429,-8585,104
GGGAGA,4.388337996875509,0.957262516730278,2.11768421447693,1.5445924131324598,6,94241,82396,75845,-11845,-6551,105
TCTCCC,4.384668767799759,0.555897985644338,2.11681423682528,1.54370685437736,6,94296,82431,75894,-11865,-6537,106
TGCCTC,4.5707642496828695,0.832128156929265,2.1079965734096398,1.54351211515699,6,91146,82817,75907,-8329,-6910,107
GCCACC,4.61750196540262,0.9359242118513359,2.12072944789712,1.5414270656845301,6,90209,82257,76014,-7952,-6243,108
TCCCAC,4.223641121905319,0.7288682647858271,2.1211706556676697,1.5413203999700702,6,96196,82239,76023,-13957,-6216,109
GGCGGG,3.9885229305851,0.472610491726869,2.17117386103673,1.54073460788472,6,98007,79956,76059,-18051,-3897,110
TCTCTG,4.3300976602714,0.731282181631618,2.09690040520808,1.54000503307448,6,95020,83353,76100,-11667,-7253,111
TGTGTG,4.7035124211615305,1.26766234459838,2.0804888755007402,1.53971025840174,6,88254,84173,76113,-4081,-8060,112
GAGGCA,4.56885924995624,0.9825982700935791,2.1026075793479198,1.5394837587295902,6,91183,83067,76129,-8116,-6938,113
CAGAGA,4.33299526778297,0.8350254501685259,2.09442850813664,1.53811152262235,6,94983,83477,76211,-11506,-7266,114
ACAAAA,4.19439217537693,0.895823334706813,2.0671480476734,1.53696930535067,6,96461,84851,76274,-11610,-8577,115
GGTGGC,4.6051007384499805,1.15419987598045,2.11089847410341,1.53417072276391,6,90456,82689,76419,-7767,-6270,116
AGCCTG,4.7152307861438,0.9052701331835759,2.08690276494008,1.5327021298825498,6,87985,83830,76517,-4155,-7313,117
CAGAGC,4.371006144327169,0.9671043858599899,2.10224246080758,1.5326023125998602,6,94507,83085,76523,-11422,-6562,118
CAGGCT,4.71537393162279,1.01566398805739,2.0862817972250802,1.53225044802199,6,87981,83871,76543,-4110,-7328,119
AGCCAC,4.3693207716015,0.952305203228788,2.10128996043337,1.53177820271031,6,94534,83135,76575,-11399,-6560,120
GTGGGA,4.20952154577088,0.575224327263369,2.10727450336741,1.53104258203004,6,96328,82852,76625,-13476,-6227,121
GGCCTC,4.60330551126174,0.864669418508141,2.10620448210126,1.53054723511401,6,90501,82909,76658,-7592,-6251,122
CTTCCT,4.444891710528401,1.06201036278763,2.07780349873703,1.5295322030260399,6,93411,84319,76721,-9092,-7598,123
CCCGGG,3.97328930517146,0.354981739301548,2.15561631259917,1.52892010918798,6,98094,80657,76761,-17437,-3896,124
GTGTGC,3.8669604272445204,0.7503677901448069,2.11827806347066,1.52704827200957,6,98691,82369,76875,-16322,-5494,125
GTGGCT,4.356897176723701,0.9155207456249309,2.09180967053083,1.5247679694793999,6,94682,83592,77018,-11090,-6574,126
CCCGGC,3.96565588679595,0.44393400364778796,2.14798289422366,1.5231179908864498,6,98138,81019,77119,-17119,-3900,127
GGCCAG,4.75096875322819,0.9822666999701128,2.08830737913722,1.5224797642903602,6,87119,83750,77154,-3369,-6596,128
CTGGCC,4.74803006136834,0.9820718384031031,2.0865269811944698,1.5210947683042402,6,87179,83856,77227,-3323,-6629,129
GAGAAA,4.227854751231701,0.73665877120802,2.05927542568122,1.5208468221656,6,96157,85250,77237,-10907,-8013,130
TTTCTC,4.22434654214934,0.746299156916769,2.0572752900932,1.5194348992754498,6,96192,85359,77311,-10833,-8048,131
TGGCCA,4.538192012663281,0.973339936472256,2.07607677106896,1.51907633690899,6,91819,84406,77334,-7413,-7072,132
GCCGGG,3.9592817247922403,0.44090074188507705,2.1416087322199497,1.5185182997672702,6,98179,81307,77359,-16872,-3948,133
TGAGGC,4.50551581283285,0.752970177553502,2.07499970174178,1.5173009447492298,6,92394,84459,77428,-7935,-7031,134
CTGTGG,4.34578526789534,0.6857406380289301,2.08069776170247,1.51629987806037,6,94804,84163,77485,-10641,-6678,135
TCAGCC,4.506582897873749,0.6543780033464599,2.07316802196878,1.51585320726376,6,92368,84546,77517,-7822,-7029,136
TCACAG,4.11187088582772,0.632083292697304,2.07341049586951,1.51558745143574,6,97171,84535,77532,-12636,-7003,137
CCCACC,4.77022085849694,1.06234421228203,2.0756364308787902,1.5136583276601299,6,86670,84430,77640,-2240,-6790,138
CCACAG,4.34395813746709,0.6749946481626611,2.07592732629896,1.51245061173729,6,94831,84413,77695,-10418,-6718,139
AATAAA,4.04401115989487,0.92378936738583,2.0232893990098404,1.5109990874096297,6,97638,87120,77781,-10518,-9339,140
GCTCTG,4.33792530270722,0.7391098240674341,2.0729695365466396,1.5103356569122,6,94920,84557,77823,-10363,-6734,141
CACACA,4.67165577940657,1.2869002922310901,2.04189324334075,1.5097666975860802,6,88971,86154,77864,-2817,-8290,142
ACATTT,3.92711832134166,0.6412392060081651,2.0392674538688,1.50857973622485,6,98402,86296,77933,-12106,-8363,143
CCTCTC,4.33586862274373,0.884481078134506,2.06801409176924,1.5065114676008502,6,94949,84801,78035,-10148,-6766,144
CTGGAG,4.65125569106344,0.949307544377625,2.05376268716899,1.50641760551543,6,89434,85537,78046,-3897,-7491,145
GGTGGG,4.75545631680941,1.05646005353102,2.06376606537412,1.50496307644176,6,87008,85025,78126,-1983,-6899,146
CTCCAG,4.64892220676119,0.94506460067571,2.05110527984282,1.5042553541506498,6,89480,85670,78170,-3810,-7500,147
GTGAGA,3.9397157719778995,0.6813910146915602,2.06515364053642,1.50406523458166,6,98303,84950,78180,-13353,-6770,148
GGCTGA,4.4902494248122,1.17589529887784,2.05675517862423,1.50346776279863,6,92670,85396,78208,-7274,-7188,149
TTTATT,4.03682370780443,0.912221998548313,2.01287174501206,1.50329957021696,6,97678,87648,78215,-10030,-9433,150
TCTCAC,3.9371110293244507,0.658311054091762,2.06421098429671,1.50315719774032,6,98318,85003,78224,-13315,-6779,151
GAGAGG,4.33390306742487,0.8877853097492869,2.06324928502629,1.50310015182955,6,94973,85044,78226,-9929,-6818,152
GAGCAG,4.30020243527491,0.714972085057658,2.06303788225859,1.50176089434002,6,95387,85052,78309,-10335,-6743,153
CTCTGC,4.45412564126646,0.97378635236864,2.05527891837783,1.5011603743454098,6,93275,85464,78344,-7811,-7120,154
AAATGT,3.91269194810089,0.629832053134787,2.02791726961597,1.49974456951244,6,98485,86900,78434,-11585,-8466,155
AGCTGG,4.641585205319809,0.7606422149766651,2.04409220142536,1.4990196150418897,6,89650,86049,78478,-3601,-7571,156
TTTAAA,4.02985835644669,0.474619800572716,2.007521494608,1.4989689048771,6,97744,87909,78485,-9835,-9424,157
AGGAAG,4.40865274727331,0.9902369994504692,2.03768636042376,1.4988557044656399,6,93937,86378,78493,-7559,-7885,158
ATGTGT,3.7960104330748496,0.454642664526261,2.04732806930099,1.49883915796079,6,99011,85877,78496,-13134,-7381,159
TCAGGA,4.2487183564102695,0.665499418332152,2.04331231449121,1.4980063904499799,6,95934,86092,78541,-9842,-7551,160
GCAGAG,4.4515361244390395,0.827993420971378,2.0503728137162303,1.49747384051312,6,93316,85709,78565,-7607,-7144,161
CCAGCT,4.6396811355767404,0.9358235294912641,2.04186420865837,1.49718690878458,6,89689,86156,78582,-3533,-7574,162
CAGAGT,4.11737195939282,0.9395284869508271,2.04721193974159,1.49668472402773,6,97131,85882,78608,-11249,-7274,163
TCTCTA,3.80948886827689,0.8931938950881179,2.0431111900676497,1.49603935108987,6,98963,86104,78640,-12859,-7464,164
CTGTCT,4.24058135038791,0.757554936501638,2.04033829136764,1.4956592277369698,6,96016,86232,78664,-9784,-7568,165
TAGAGA,3.81016648727632,0.369731103321492,2.04066563461908,1.4942501983109497,6,98960,86211,78764,-12749,-7447,166
ACTGCA,4.2998862555765704,0.8089680773641079,2.03491358981635,1.4933823443031,6,95391,86504,78822,-8887,-7682,167
TGCAGT,4.29756297107311,1.13755389517984,2.03405139334715,1.4928243852696899,6,95416,86549,78860,-8867,-7689,168
TCCTGA,4.2404286905988,0.9109592263429391,2.03618094259682,1.49252759666199,6,96018,86456,78884,-9562,-7572,169
CTGTGC,4.12472795854334,0.7107648096993611,2.0571284394391998,1.49170478344641,6,97054,85369,78936,-11685,-6433,170
GCACAG,4.12635154571096,0.646563952580545,2.05613264465548,1.49086762230517,6,97040,85430,78989,-11610,-6441,171
CCCTGC,4.51490522613373,0.924802190332787,2.05089013304858,1.4873278742266203,6,92226,85679,79203,-6547,-6476,172
AGGAAA,4.3416926542465,0.8161219054302159,2.00911457098954,1.4871672977398998,6,94864,87838,79213,-7026,-8625,173
GCACAC,3.81810558770742,0.39539843937192404,2.06493056366354,1.48655012974468,6,98915,84962,79256,-13953,-5706,174
TCCTCC,4.463814333363589,0.520798302653265,2.0315577513756997,1.4840747468859399,6,93112,86684,79416,-6428,-7268,175
GCCTCA,4.46201543138911,0.9596696452730791,2.03041128408013,1.4831696332331699,6,93150,86752,79471,-6398,-7281,176
GCTGGT,4.1423206401887205,0.9482758367310551,2.0442100267992402,1.48299814916662,6,96939,86042,79483,-10897,-6559,177
AGAAAA,4.44257479129939,0.82958214655534,1.98438625392853,1.4824191598286203,6,93446,89112,79522,-4334,-9590,178
CAGCAG,4.46213637770098,0.686459898116159,2.0293739364749097,1.48240632452926,6,93145,86813,79525,-6332,-7288,179
CCTCTG,4.48939506790514,0.861343651032666,2.02662739163191,1.48135685914352,6,92687,86967,79599,-5720,-7368,180
GAGTGC,3.95441661169689,0.7193791556154621,2.04965755638215,1.4805039613361202,6,98211,85752,79645,-12459,-6107,181
ACCAGC,4.14197071897095,0.25869072168414303,2.0401526874122,1.47972795090312,6,96940,86237,79702,-10703,-6535,182
CCATGT,4.01486173494813,0.7277216920355591,2.0276886765911897,1.4791442874291598,6,97845,86910,79729,-10935,-7181,183
GCACTC,3.9525195950531202,0.710085831576155,2.04786103892812,1.47898967646473,6,98225,85845,79734,-12380,-6111,184
GGAGGA,4.45893575092758,1.0405018623293,2.02428321082252,1.47872605310479,6,93202,87069,79758,-6133,-7311,185
CCCTCC,4.69257033819867,0.7495543074883481,2.0307433350008703,1.4784863433605098,6,88513,86736,79775,-1777,-6961,186
TCCCTC,4.29727986245472,0.8509976115647719,2.02942533148023,1.47714547406349,6,95419,86807,79872,-8612,-6935,187
GAGGGA,4.29972589272758,0.90906280107466,2.0290721103290097,1.4770920852026699,6,95392,86831,79879,-8561,-6952,188
GCAGGG,4.50166569278614,0.877783254193831,2.0368162288078304,1.4768160298977,6,92451,86416,79900,-6035,-6516,189
CAGAGG,4.48608864663036,0.849524759587213,2.01983697602204,1.47627029688765,6,92750,87297,79930,-5453,-7367,190
ACACAT,3.77014662664852,0.734019049963104,2.01697160260465,1.4755051318461498,6,99104,87428,79971,-11676,-7457,191
TAAATA,3.6134638943920203,0.453744572108315,1.9918206064002202,1.4753703161432001,6,99589,88708,79978,-10881,-8730,192
CTGCTG,4.44934820457754,0.696712598202744,2.01999038740356,1.4753041985049298,6,93349,87288,79981,-6061,-7307,193
CCCCAG,4.68890648818365,0.6102655424229261,2.0259211910687602,1.4748466730140901,6,88584,87010,80005,-1574,-7005,194
CTGAGA,4.2179379270062,0.7314885459967759,2.01212859178022,1.4741873924088,6,96244,87682,80039,-8562,-7643,195
ACATGG,4.00928130968714,0.718068821983058,2.02097108631986,1.4740550286486798,6,97881,87235,80050,-10646,-7185,196
TATTTA,3.6125037071882002,0.8265486442961179,1.98924531824274,1.47358071059963,6,99591,88857,80080,-10734,-8777,197
TTTTCT,4.4314952148877005,0.8209471231924799,1.9712347695266002,1.4725748255873201,6,93614,89804,80129,-3810,-9675,198
GGAGGG,4.6843807761194105,1.03826197655915,2.02204332505237,1.4721634457306,6,88685,87184,80153,-1501,-7031,199
TCTTTT,4.2721278920461,0.825981851364275,1.9762694976983899,1.4719304453059598,6,95701,89567,80167,-6134,-9400,200
CAGTGT,3.92287221467221,0.529019181479244,2.02111893501609,1.47145961014021,6,98424,87225,80189,-11199,-7036,201
CTGGGG,4.680927561026469,0.9152932610851591,2.01974840387652,1.4703908699042902,6,88765,87301,80242,-1464,-7059,202
AAATTA,3.75846297034221,0.818537373687478,1.9787495706415201,1.46983435216149,6,99144,89419,80275,-9725,-9144,203
ACTCCA,4.08196213278973,0.6306540610292211,2.01190261232825,1.4696116335903702,6,97393,87695,80291,-9698,-7404,204
GGCAGA,4.4761714492771105,1.0261041888683,2.0099197786687903,1.46870795956146,6,92902,87803,80339,-5099,-7464,205
TGGAGT,4.07802097534668,0.98557708843475,2.01010728583046,1.4684655550367502,6,97413,87794,80359,-9619,-7435,206
TCACAC,3.7752764624116097,0.35256931407611697,2.0221014383677303,1.4671204631366501,6,99091,87181,80448,-11910,-6733,207
TAATTT,3.75620851128034,0.780660362133052,1.9748800106259798,1.46703841226033,6,99152,89636,80453,-9516,-9183,208
GTGTGA,3.7671361786545803,0.7097617280792929,2.0184538148807203,1.46450707403434,6,99111,87364,80610,-11747,-6754,209
GCAGGC,4.29663459434398,0.47892040887629905,2.02927311745439,1.46437359181331,6,95425,86818,80623,-8607,-6195,210
GCCTGC,4.29479839806018,0.704695362259239,2.02859521508768,1.46383205065869,6,95451,86866,80654,-8585,-6212,211
CACGCC,3.83362178093005,0.544584668501008,2.0480358111099997,1.46137424674349,6,98847,85839,80804,-13008,-5035,212
CAGGCA,4.6519837362497904,0.91951636826404,1.99013417743173,1.4596241647456598,6,89412,88800,80927,-612,-7873,213
CAGCCC,4.5083473204007,0.8084505755283741,2.0115748028952,1.4585171863199198,6,92339,87714,81007,-4625,-6707,214
TCTGCC,4.45938881131074,0.72687588090195,1.99662113503751,1.4584829743154197,6,93193,88466,81009,-4727,-7457,215
GGCGTG,3.8267108571818103,0.538100187670437,2.0436951405207,1.45835593280402,6,98882,86068,81016,-12814,-5052,216
TGCCTG,4.64606515198434,0.8361044990241221,1.9883843304123703,1.45831361360513,6,89546,88894,81018,-652,-7876,217
AAACAC,3.82542383527105,0.471673543393635,1.99073581364227,1.45794759814807,6,98889,88762,81040,-10127,-7722,218
CTTCCC,4.42906151150711,0.9590081007820269,1.99680492951923,1.45759252356328,6,93648,88458,81057,-5190,-7401,219
TTTCCT,4.297807709898411,0.7676806419049079,1.9663344068288702,1.45439918833783,6,95414,90046,81250,-5368,-8796,220
CAGGCG,3.82338880916223,1.49281717898172,2.03812676236611,1.45409294773521,6,98895,86352,81272,-12543,-5080,221
GGGCTG,4.49510200999134,0.6535827991033221,2.00089974564477,1.45064305705821,6,92579,88249,81477,-4330,-6772,222
GACAGA,4.21800653701008,0.9142702712630871,1.97943977736375,1.45016357264043,6,96241,89378,81501,-6863,-7877,223
ATTCTC,3.90090575652547,0.5785317238697071,1.97645796660734,1.45002574614932,6,98538,89556,81509,-8982,-8047,224
CGCCTG,3.81517622720159,0.00521557424137065,2.0318365875165503,1.4493192939189101,6,98937,86669,81550,-12268,-5119,225
ACAGAA,4.13015797354449,0.7654126923572641,1.9645255422483798,1.44794686896481,6,97019,90120,81642,-6899,-8478,226
GCCCAC,4.14779546882881,0.653022611709318,2.0135664914938998,1.4478097148325,6,96891,87616,81650,-9275,-5966,227
AAACAA,4.07814741723071,0.854297534005647,1.9509032895271798,1.44728539260225,6,97411,90798,81684,-6613,-9114,228
AAATAT,3.88142925103233,0.9507980660347021,1.94364573962275,1.44716091999769,6,98627,91206,81695,-7421,-9511,229
GGGAAG,4.417085485013191,0.947197517703225,1.98243294490813,1.44684592092701,6,93822,89209,81719,-4613,-7490,230
CAGCTA,3.97993553209248,0.8826132604863409,1.9846398673522299,1.4465607860379197,6,98055,89092,81740,-8963,-7352,231
TTGTTT,4.0748325713683,0.8424322588925959,1.94581932979169,1.44383604658303,6,97436,91073,81918,-6363,-9155,232
ACTCTG,4.043248132340049,0.4444326537002701,1.9754349420135802,1.44191409561518,6,97641,89612,82055,-8029,-7557,233
GTGGGC,4.13753520423206,0.660496650591739,2.00509123795533,1.4416775404797302,6,96970,88039,82077,-8931,-5962,234
CTGTGA,4.0131243418776,0.6583793795580439,1.9757217466467198,1.44125086275177,6,97860,89600,82112,-8260,-7488,235
TAGCTG,3.97016752431156,0.5571666671341651,1.97711818970633,1.4409200878556498,6,98107,89514,82137,-8593,-7377,236
ATATTT,3.87305591863196,0.7175001182838321,1.93365730626871,1.43963263225571,6,98659,91748,82203,-6911,-9545,237
ACACTG,3.88026090428526,0.4086211536269829,1.9778317786956299,1.4384401643000702,6,98631,89476,82289,-9155,-7187,238
AAAAGA,4.22213166052191,0.7731377734843409,1.92794188085753,1.43428834438916,6,96210,92032,82595,-4178,-9437,239
CAGCTC,4.23260552166954,0.645113350952981,1.96540342537395,1.42848958136722,6,96091,90083,82971,-6008,-7112,240
TCCCCA,4.42217668726121,0.773108212275217,1.9571626808529698,1.4283647928654,6,93743,90469,82979,-3274,-7490,241
TATAAA,3.55167888572034,0.5635457474776501,1.9300355977285502,1.4278624774886297,6,99730,91944,83004,-7786,-8940,242
CAGCCA,4.4194709971930095,0.750507507888585,1.95510942546368,1.42677279499504,6,93781,90581,83064,-3200,-7517,243
GAGCTG,4.228325103624161,0.6546151900119189,1.9618077502395799,1.42588031127795,6,96152,90249,83124,-5903,-7125,244
TCCTTC,4.1512923850423,0.87353826643032,1.94860622426433,1.4256475403981599,6,96866,90913,83139,-5953,-7774,245
GAAAGA,4.10355478972145,0.81702703778608,1.93497546417097,1.4254590194947498,6,97246,91681,83156,-5565,-8525,246
ACCTCC,4.22781688512226,0.284800854411937,1.9609443678712202,1.4250270985181699,6,96158,90289,83180,-5869,-7109,247
CCAGGT,4.22610892328935,0.853498520988369,1.9595392001554799,1.4240914988338997,6,96178,90357,83242,-5821,-7115,248
GAAGGA,4.15296524236814,0.939788092103239,1.94599761322507,1.4237624824558899,6,96845,91062,83271,-5783,-7791,249
TCTTTC,4.09963881355775,0.9071451023012859,1.93256756150161,1.42373494435191,6,97275,91813,83273,-5462,-8540,250
TTCTTT,4.36720416003411,1.05662275709318,1.9069437146730102,1.4228414030775902,6,94560,93061,83322,-1499,-9739,251
TGGCTG,4.40947817534545,0.567958964457437,1.9496092638861298,1.42274261645295,6,93924,90869,83325,-3055,-7544,252
TGGGGA,4.41217972034372,0.912938952665501,1.9481743798704099,1.4217695817911002,6,93888,90944,83389,-2944,-7555,253
CAGAAA,4.2860181583929,0.621334817034937,1.9218409446326798,1.4209345634628998,6,95557,92303,83448,-3254,-8855,254
ACCTGG,4.22105320612606,0.266606260712091,1.95450461189894,1.42027211462883,6,96219,90619,83492,-5600,-7127,255
AAATAA,4.07801808655242,0.9257369869920641,1.8992262139585,1.41924379640183,6,97414,93480,83557,-3934,-9923,256
TGCTGG,4.564888175968799,0.683945185625657,1.9380423717061002,1.41902431348445,6,91258,91500,83570,242,-7930,257
CCAGCA,4.56842686014317,0.831811829637337,1.93785250880445,1.41870768324772,6,91193,91512,83589,319,-7923,258
GCAGCC,4.42527001378337,0.5730651192560731,1.96009662678113,1.4185841735624098,6,93707,90327,83597,-3380,-6730,259
GGCTGC,4.4217228279165,0.8765390918460841,1.95803165785527,1.4171263939291001,6,93752,90424,83692,-3328,-6732,260
TGGAGA,4.171140262518421,0.740064782373191,1.9348198330071003,1.41620744535358,6,96693,91691,83761,-5002,-7930,261
GGAGGT,4.21451919879426,0.9644920501910921,1.94827339868431,1.4156781593741599,6,96288,90936,83797,-5352,-7139,262
CTTCTC,4.1380819705671,0.78547851480959,1.9353958097891202,1.41558337486654,6,96963,91652,83804,-5311,-7848,263
TTATTT,4.07598849686971,0.918318288009836,1.8939664223684498,1.41552363226271,6,97433,93757,83810,-3676,-9947,264
AGGCAC,4.02685863647725,0.701227798914646,1.95663973542177,1.4155192623412902,6,97764,90496,83811,-7268,-6685,265
CTCCTC,4.3728618758934905,0.81877041787258,1.9406052939056102,1.4148400360484499,6,94486,91358,83845,-3128,-7513,266
GAAAAA,4.195379810323979,0.36164494260937297,1.9011900306596101,1.41366281270872,6,96449,93374,83926,-3075,-9448,267
GTGCCT,4.01827864876059,0.493448487200881,1.9506791296564499,1.41109402778954,6,97819,90810,84086,-7009,-6724,268
TGGAGG,4.397796576374089,0.462768343770668,1.93379123590078,1.41083185578293,6,94096,91740,84110,-2356,-7630,269
CCTCCA,4.39802459933977,0.811175716898509,1.9330105929315302,1.40999804057381,6,94092,91784,84168,-2308,-7616,270
GAGAAG,4.13439357700377,0.786195614607941,1.9274259478606999,1.4096156017196102,6,96996,92059,84194,-4937,-7865,271
AGAGAG,4.44910781907454,1.0735472782876099,1.9141426745185102,1.4091521267850802,6,93354,92689,84226,-665,-8463,272
TGGTGA,3.99935174265759,0.7371977568464241,1.9314380531413702,1.40859277424146,6,97948,91869,84267,-6079,-7602,273
TCCCTG,4.39329892909172,0.763596941464389,1.93053125281849,1.4081894118517,6,94173,91926,84289,-2247,-7637,274
AAAGAA,4.34646330767672,1.05218686732864,1.8882747703058702,1.4080904184523702,6,94795,94027,84299,-768,-9728,275
TTTTTC,4.1888132726139995,0.742667231932172,1.8929548782662902,1.40764165844961,6,96524,93806,84338,-2718,-9468,276
TCACCA,3.9986110942869706,0.606592469838418,1.92855157382549,1.4061841534639998,6,97951,92007,84437,-5944,-7570,277
GAGGAG,4.36350371154595,0.779431377683537,1.9288511714409,1.4061008780639899,6,94608,91993,84441,-2615,-7552,278
CTGCTC,4.17139863131466,0.5954268972031209,1.9369539594394298,1.40596704344396,6,96687,91572,84452,-5115,-7120,279
CAGGGA,4.39343645971917,0.8565669799431591,1.92718478911085,1.4057342682980503,6,94171,92070,84474,-2101,-7596,280
TTCTGT,4.07360604234752,0.808954833906869,1.90897789204908,1.4056722454161799,6,97444,92948,84480,-4496,-8468,281
TGAGCC,4.548629491612339,1.12885031661322,1.9203014704086203,1.40540775668417,6,91589,92377,84497,788,-7880,282
CTCTCT,4.439704230996201,1.0026094628656501,1.9082139681914398,1.40454313105514,6,93486,92992,84560,-494,-8432,283
TCTCTT,4.074552946933149,0.757564399897476,1.90748169487701,1.40453430620219,6,97438,93036,84564,-4402,-8472,284
AAGAGA,4.0760165636996,0.6355811797447671,1.9074372381491203,1.4043815272668898,6,97432,93038,84574,-4394,-8464,285
TTTATA,3.5211270641786,0.586144528066972,1.89786867523314,1.4033533655938601,6,99821,93551,84633,-6270,-8918,286
TCTCCA,4.152708150777101,0.7014000790165961,1.9172645655787801,1.4026848236578797,6,96847,92511,84685,-4336,-7826,287
GCCCTG,4.43125308230358,0.801551094676244,1.93672689493308,1.40194138955098,6,93618,91583,84745,-2035,-6838,288
GGCTCA,4.5442569738417,1.1277150018187199,1.91516483944399,1.4015175311805401,6,91684,92630,84787,946,-7843,289
CCTCAC,4.038485141468721,0.7098463374717758,1.9360146752310698,1.4009108452789099,6,97667,91617,84831,-6050,-6786,290
ACCCAC,3.87848859305044,0.38371573593095204,1.94140219154964,1.3995351924646202,6,98637,91316,84910,-7321,-6406,291
TGGCAC,4.0327630560694505,0.672131039078568,1.93319135464571,1.3988262026633302,6,97713,91769,84963,-5944,-6806,292
GTGCCA,4.030039959135141,0.669967418179983,1.92968301561065,1.3962000738999998,6,97741,91957,85143,-5784,-6814,293
CCTGTA,4.10086162424225,0.8399850831859399,1.91000037952436,1.39588628748009,6,97269,92899,85170,-4370,-7729,294
TACAGG,4.10257598129969,0.7522028060197049,1.90979232947072,1.39577592385807,6,97255,92911,85180,-4344,-7731,295
TGCCAC,4.21789868547475,0.800883117102035,1.9205150739383603,1.39540667831418,6,96245,92365,85215,-3880,-7150,296
TCACTC,3.7949418739768,0.610932656651787,1.9220418289490602,1.3952178979524699,6,99015,92295,85234,-6720,-7061,297
CAGGGC,4.424126375723009,0.8266247578623579,1.92767778124143,1.3951545424273601,6,93722,92046,85237,-1676,-6809,298
GTGGCA,4.21649396653189,0.7901045220426841,1.9186490359186799,1.39414498373088,6,96261,92459,85303,-3802,-7156,299
GTGAGG,4.02851311236774,0.581053521143897,1.92626606996427,1.3938207780578,6,97753,92112,85325,-5641,-6787,300
ACTCCT,3.9506722830511003,0.360603188018903,1.91337018700997,1.39373028756209,6,98235,92722,85331,-5513,-7391,301
CCAGGG,4.5814292346822105,0.812727181424139,1.9187678605912502,1.3936504770041298,6,90942,92453,85337,1511,-7116,302
CAGCTG,4.37289491215188,0.608738869172077,1.91077967055756,1.39315376626425,6,94483,92871,85370,-1612,-7501,303
CCCTGG,4.578195617603081,0.623748672189116,1.9166925374291999,1.39205247911345,6,91003,92548,85440,1545,-7108,304
GAGTGA,3.7915161282532,0.6156968586962039,1.9169539968117197,1.3915470204221698,6,99033,92529,85480,-6504,-7049,305
GTGGGT,3.86381826685049,0.698598644516091,1.92997796444213,1.3912731268457401,6,98712,91945,85500,-6767,-6445,306
TTTCTG,4.2422996990714,0.587588441575583,1.88031530171652,1.3892984410826101,6,95999,94391,85658,-1608,-8733,307
CCCAGA,4.37098625385914,0.8911184416301391,1.9044106602268898,1.38830937335106,6,94508,93209,85736,-1299,-7473,308
AGGCCA,4.33526376304572,0.8054128662829659,1.90250132181965,1.38590100812611,6,94958,93309,85900,-1649,-7409,309
ATGTGC,3.69959938923203,0.610694201055175,1.9102382409877399,1.3838069120395702,6,99355,92890,86055,-6465,-6835,310
CTCCCC,4.56735838975892,0.920855825147616,1.90553138656112,1.38347307682711,6,91208,93144,86080,1936,-7064,311
GTGGAG,4.171221144454701,0.7087528484026779,1.9049753443447501,1.38287696866097,6,96690,93175,86124,-3515,-7051,312
CCCTGT,4.17036269406887,0.8226971336017451,1.90495126485209,1.3827054259578402,6,96700,93178,86137,-3522,-7041,313
GGGGAG,4.56636094962357,0.743707186135893,1.90402349855653,1.38261173174592,6,91229,93229,86142,2000,-7087,314
GAGAAT,3.81349691094392,0.7446956133250161,1.88592594657778,1.3810420677585,6,98944,94132,86270,-4812,-7862,315
ACAGGG,4.17013484936958,0.546252410777271,1.9024279612253703,1.38084742439057,6,96702,93316,86281,-3386,-7035,316
TCATTT,3.91989736808452,0.6571486273752328,1.86666243587482,1.3807637469001102,6,98438,95023,86287,-3415,-8736,317
AGCCAG,4.48757802732708,0.7825621273245141,1.8886028064916203,1.3803313145819198,6,92720,94011,86315,1291,-7696,318
GAAAAT,3.9190074476582004,0.5799642784607301,1.8658260291781599,1.3799740298437602,6,98450,95063,86338,-3387,-8725,319
GTGTTT,3.72053219567706,0.363191449925498,1.8871512491631202,1.3794233515410101,6,99274,94082,86385,-5192,-7697,320
AGGAGT,3.93231400260581,0.839870115693886,1.8937531134578502,1.37900930604543,6,98361,93773,86414,-4588,-7359,321
AAATGA,3.9176679986614102,0.662395737963702,1.86448658018138,1.37894678369146,6,98460,95131,86418,-3329,-8713,322
GAAATA,3.76527920142644,0.6055598791427371,1.8701678946553,1.37892461293863,6,99115,94860,86421,-4255,-8439,323
GCCAGC,4.21286371490475,0.32958371761794103,1.9139031075118997,1.37834208518677,6,96296,92699,86473,-3597,-6226,324
CTGGCT,4.48207793233011,0.781288079561385,1.88574322235275,1.37822734179151,6,92814,94142,86480,1328,-7662,325
TCTGGG,4.353302401610771,0.286124527133865,1.89085864836147,1.37818253567287,6,94721,93896,86486,-825,-7410,326
TGGCCT,4.3212099498525,0.785749509488412,1.89185213267852,1.37787024968708,6,95109,93853,86507,-1256,-7346,327
ATTTTC,3.91512939331648,0.5891038786623671,1.8618944611067803,1.37710630151543,6,98470,95239,86567,-3231,-8672,328
GCTGGC,4.20799915576758,0.627213228989751,1.9112848785097398,1.37645132690044,6,96349,92846,86611,-3503,-6235,329
TTGTGT,3.71286573741054,0.37149796886194697,1.8794847908966001,1.3735935246543403,6,99303,94432,86809,-4871,-7623,330
TCTGTC,4.11130907738559,0.9101758759521191,1.87811182232227,1.3729621249383999,6,97178,94494,86865,-2684,-7629,331
CTCCCG,3.6839136886547403,1.4307976018873798,1.93108514325504,1.3728235922901002,6,99404,91891,86878,-7513,-5013,332
ACTCAC,3.6187593942485,0.339959419015814,1.8983417946249699,1.3724326364135502,6,99579,93520,86904,-6059,-6616,333
GAGCCC,4.20687400483958,0.697423389334814,1.90569937554382,1.37224069603318,6,96354,93132,86919,-3222,-6213,334
CGGGAG,3.68132997862312,-0.141323784864563,1.92766706233026,1.3704454235570902,6,99407,92047,87034,-7360,-5013,335
GAGACA,4.11328699995871,0.7334899070596209,1.87472024031238,1.37038423809642,6,97160,94642,87038,-2518,-7604,336
CTCCCT,4.47171341369196,0.89037921927717,1.87505478069067,1.3699804958051398,6,92968,94626,87059,1658,-7567,337
TAGAAA,3.75290427850708,0.2617082984834,1.8577929717359498,1.3694564394533997,6,99170,95406,87099,-3764,-8307,338
TGTCTC,4.10662439057671,0.7235098405338579,1.87342713551339,1.3694000638487198,6,97220,94712,87103,-2508,-7609,339
ATGTGG,3.86979523403275,0.5389251095427701,1.88294609869973,1.36932457779329,6,98675,94262,87107,-4413,-7155,340
GGGCTC,4.19984039916837,0.6939374074542322,1.90055128012054,1.36845808410516,6,96409,93410,87170,-2999,-6240,341
CCTGGA,4.33764662263329,0.803302062797634,1.8733173591360501,1.36478839632449,6,94925,94718,87441,-207,-7277,342
AGGGAG,4.465926985202549,0.643273221714868,1.86727568739101,1.3642385278296998,6,93080,94993,87480,1913,-7513,343
ACACCA,3.78425853701747,0.39223991256891294,1.87958308129283,1.36391702064717,6,99058,94428,87502,-4630,-6926,344
GCACAT,3.67463858263729,0.63851100595187,1.88381634635874,1.36374524285604,6,99426,94217,87515,-5209,-6702,345
TGGTGT,3.7781432768276204,0.48840165674805497,1.8786363273065,1.3634756702803401,6,99079,94470,87536,-4609,-6934,346
CTCGGC,3.67044836679294,0.261131057800558,1.91794374441717,1.3630876165738701,6,99443,92493,87554,-6950,-4939,347
TATAAT,3.2339961934579,0.6346931551390171,1.85336126665045,1.3624145987930603,6,100533,95587,87601,-4946,-7986,348
GCCGAG,3.6708732855501003,0.26134925300807604,1.9168864462333102,1.3623419899226201,6,99441,92535,87611,-6906,-4924,349
CCACAT,3.86248478589319,0.668662402899431,1.87385063950199,1.36221251685337,6,98720,94684,87619,-4036,-7065,350
CGCCTC,3.51223277412777,-0.22640331862583302,1.92380627974147,1.3616024593791203,6,99848,92217,87662,-7631,-4555,351
TGGCAG,4.30071819712727,0.568291251103782,1.87020208603621,1.36147917190996,6,95379,94859,87670,-520,-7189,352
CTCAGG,4.49131389496548,0.791603951400075,1.86222176056777,1.3612327199003602,6,92653,95229,87691,2576,-7538,353
AGACAC,3.7499097674170097,0.562872999283114,1.8768334421956399,1.36093583912525,6,99181,94543,87718,-4638,-6825,354
TCCAGG,4.332748038448471,0.374513565940255,1.8680579550641598,1.3608096782561103,6,94989,94950,87727,-39,-7223,355
GTGTCT,3.74401494903961,0.5583590468976031,1.87501909380384,1.3597376388776001,6,99204,94628,87804,-4576,-6824,356
GAGGCG,3.50937678733173,1.17880515715122,1.9197126287453503,1.3587488119473001,6,99861,92404,87878,-7457,-4526,357
ATTATA,3.22907826335899,0.726280926608096,1.8484433365515398,1.3586611538634898,6,100550,95773,87885,-4777,-7888,358
CTCCAC,4.13916117028955,0.7537621900013549,1.87228865303851,1.3578990806415803,6,96958,94763,87938,-2195,-6825,359
TCACAT,3.6211110242488096,0.584983447563394,1.8620472990675199,1.35787346586346,6,99574,95234,87942,-4340,-7292,360
CTGCCA,4.29684469077124,0.639401638071826,1.86524054346226,1.35761950403247,6,95424,95092,87967,-332,-7125,361
CAGAAG,4.25325903535917,0.8595516964041221,1.8506935180063502,1.35685062970337,6,95891,95687,88034,-204,-7653,362
TTTCTA,3.73612762016672,0.887286707423721,1.84096279966591,1.35673446153916,6,99227,96025,88041,-3202,-7984,363
ACAGGT,3.74218698868322,0.5463185468113371,1.8705717514961002,1.35630290897921,6,99207,94845,88069,-4362,-6776,364
AATATA,3.45827868955455,0.680686616890275,1.83663540156275,1.35623400091528,6,99986,96145,88077,-3841,-8068,365
TCCTGT,3.8994205838848104,0.551755023417682,1.86357957587794,1.35607161184948,6,98541,95166,88095,-3375,-7071,366
GTGAAA,3.8504968825827497,0.49470448957406393,1.8503242970273799,1.35603252714076,6,98779,95700,88096,-3079,-7604,367
CCTTCC,4.48172678772646,1.04424220148878,1.8555146932504902,1.3559958606956002,6,92820,95491,88103,2671,-7388,368
ACTCAG,3.9020237222103398,0.31084308248687104,1.86356333225213,1.35598745876278,6,98531,95169,88104,-3362,-7065,369
ACCTGT,3.7405865771021003,0.39292101663497203,1.8701296338320699,1.3559428450902,6,99215,94863,88107,-4352,-6756,370
ATGCCT,3.97897247594477,0.454142314385067,1.8583641239159798,1.3545666151175502,6,98063,95376,88212,-2687,-7164,371
ACAGGA,3.90126802383466,0.31804908575653495,1.86124604665243,1.35426917260869,6,98536,95266,88240,-3270,-7026,372
CTGAGC,4.10372177675878,0.711340454896618,1.8677155176595401,1.35363371231604,6,97245,94968,88283,-2277,-6685,373
AGGCAT,3.97874735009448,0.7860461019106421,1.8569807041486002,1.3535430198156797,6,98064,95441,88289,-2623,-7152,374
TATATT,3.45590037250081,0.681081424692612,1.83264198355535,1.35335725371767,6,99996,96266,88298,-3730,-7968,375
ACATAT,3.4900522305521102,0.828780486094962,1.84482482521726,1.3525359012668798,6,99910,95899,88360,-4011,-7539,376
CCTGAC,4.16121199200772,0.7938130841329141,1.86382838047133,1.35250195059111,6,96777,95158,88367,-1619,-6791,377
GCTCAG,4.10160861627039,0.510427976546911,1.86600565047806,1.3523300674128003,6,97263,95052,88381,-2211,-6671,378
CCCCTC,4.36765793403292,0.7483981058154879,1.87023298184851,1.3516987716260502,6,94552,94857,88419,305,-6438,379
CCTGAG,4.477973152670231,0.7796298351280959,1.84964513146651,1.35165260170418,6,92866,95720,88424,2854,-7296,380
TCACCT,3.89444195730506,0.621543154840417,1.8571398612639298,1.35109571345743,6,98561,95433,88462,-3128,-6971,381
ACCCCA,4.1606806846698,0.511612209683813,1.8610507429984098,1.35032765327374,6,96783,95274,88512,-1509,-6762,382
AGGTGA,3.89383934983608,0.666686543453189,1.85527846068812,1.34984657206994,6,98567,95502,88548,-3065,-6954,383
ATGTGA,3.60954939179147,0.560803883006182,1.85038516742043,1.34915923559235,6,99600,95698,88603,-3902,-7095,384
ACATGT,3.60143849302085,0.5879380385952211,1.8505097991119799,1.3489464018029698,6,99619,95696,88616,-3923,-7080,385
ATATGT,3.48233310624462,0.8118379746214079,1.83856678894404,1.3478622624934098,6,99927,96091,88698,-3836,-7393,386
TGGGGT,4.15241591497196,0.849511302650663,1.8568173144937599,1.3474247457956499,6,96849,95448,88743,-1401,-6705,387
GTCAGG,4.15429222439797,0.785829484617068,1.85644729378476,1.3470702638038798,6,96833,95463,88765,-1370,-6698,388
TTTCAC,3.83782122024467,0.482522575624376,1.8361340329253701,1.3452899036004902,6,98830,96165,88896,-2665,-7269,389
ACACTC,3.5827140623661804,0.375574470416961,1.86229646274265,1.3452548103393,6,99654,95226,88901,-4428,-6325,390
TTTCAT,3.8735510559477904,0.682460468157624,1.82031612373809,1.34523963555156,6,98656,96567,88902,-2089,-7665,391
TGGGAT,4.18579362934231,0.829880184096352,1.83718619593945,1.3452348167377202,6,96559,96127,88903,-432,-7224,392
TATTTC,3.71961850241652,0.735083495317635,1.8244536819157202,1.3441158531842101,6,99277,96475,88992,-2802,-7483,393
CTGAGT,3.8842166640871296,0.7178936282501508,1.84681406885625,1.34341167054306,6,98613,95827,89033,-2786,-6794,394
ATGTTT,3.70959678956123,0.519978150008871,1.82320701012263,1.34298373895939,6,99310,96504,89068,-2806,-7436,395
GAGGGG,4.35613974433582,0.737791741720923,1.85780105097527,1.3426222415652,6,94688,95405,89100,717,-6305,396
CAGGTG,4.49581490475045,0.7655938668997081,1.8362116760673999,1.3424132360523,6,92561,96160,89113,3599,-7047,397
TTGGGA,4.228594229683879,0.594297011176367,1.83071489221774,1.34171052213129,6,96147,96312,89172,165,-7140,398
GGAAGG,4.460153530659969,1.0948389199600799,1.83620438318552,1.34137106381952,6,93182,96161,89203,2979,-6958,399
TCCCAA,4.22338639350055,0.790562992450965,1.82835982118816,1.3395784731398501,6,96200,96378,89334,178,-7044,400
GCAGGT,3.92431722196302,0.7284487800911371,1.8555594089417902,1.33936902127187,6,98414,95489,89359,-2925,-6130,401
CCCAGT,4.14444380537216,0.832982733138275,1.84627495173503,1.3392583338953998,6,96916,95849,89369,-1067,-6480,402
ACACAA,3.66887365059077,0.692679637606107,1.83418562896198,1.33879785650621,6,99447,96216,89395,-3231,-6821,403
CACCTG,4.4914084241840895,0.7614659761386949,1.8314812724771101,1.33870171242791,6,92650,96292,89402,3642,-6890,404
AAATAC,3.7031918399567902,0.843466846471172,1.8169560734376002,1.33793721970678,6,99342,96649,89456,-2693,-7193,405
TCTCAT,3.75264129218602,0.6782762072883579,1.82819350226789,1.33704922989429,6,99171,96383,89515,-2788,-6868,406
GTATTT,3.7004720472348196,0.54491624688669,1.8140822677962198,1.3360135165483,6,99351,96706,89601,-2645,-7105,407
AAACAT,3.7003629837563103,0.510820748709016,1.8141272172371299,1.3357768583015202,6,99352,96704,89620,-2648,-7084,408
GCATGG,4.03134595223161,0.7048392929997809,1.84589315303022,1.33568354575597,6,97732,95860,89625,-1872,-6235,409
ATCCCA,4.17568311877528,0.533988308959032,1.82450543221349,1.33540319386088,6,96645,96473,89645,-172,-6828,410
CCATGC,4.03105621415109,0.7122856189824921,1.8452794919257802,1.33509404113763,6,97736,95886,89668,-1850,-6218,411
GTTTGT,3.66126242830907,0.45719489156278603,1.8278814817951299,1.33439492806319,6,99469,96400,89719,-3069,-6681,412
ATTTCT,4.01770550187304,0.530667661590542,1.8000685186499399,1.33407473638314,6,97824,96908,89740,-916,-7168,413
TCACCC,3.94985734875987,0.5860721692782459,1.84738688252223,1.33405545731623,6,98243,95807,89742,-2436,-6065,414
TGAGAC,4.060108946324711,0.877763616053347,1.82673541106776,1.33385336082356,6,97528,96432,89753,-1096,-6679,415
GTCTCA,4.05953952878759,0.77385453203533,1.8265390453469699,1.33370173051731,6,97531,96437,89767,-1094,-6670,416
CACAGA,4.25297614661423,0.8349959089576658,1.81881149875815,1.33340584946042,6,95893,96604,89785,711,-6819,417
GTGCCC,3.9936243123997497,0.5521353989172579,1.8608564230991,1.33320617054067,6,97970,95283,89801,-2687,-5482,418
ATGAGA,3.74985559613294,0.4915308388465971,1.8222846317668,1.33263104801591,6,99182,96526,89834,-2656,-6692,419
GAAAAC,3.82114814579196,0.746271190708736,1.81951447220233,1.33249235079944,6,98903,96584,89843,-2319,-6741,420
TGCCCA,4.48109012786167,0.8078707575579409,1.8211629761547,1.3308648336592,6,92831,96547,89934,3716,-6613,421
TTTTTG,4.27663812722161,0.635578941241039,1.78586658757516,1.33028724628183,6,95654,97115,89976,1461,-7139,422
ACACCT,3.7058883837051897,0.432989581240548,1.8339703524009,1.32853870299003,6,99331,96227,90100,-3104,-6127,423
GGGTGA,3.94175917672152,0.657082956799375,1.83951213431805,1.3283901570644299,6,98287,96064,90109,-2223,-5955,424
GTTTTC,3.81370768383672,0.487682169182603,1.8134815845516798,1.32814770900023,6,98942,96714,90131,-2228,-6583,425
ATGTAT,3.4554301956460804,0.7059202377195358,1.8116638783454901,1.32738607552314,6,99997,96752,90179,-3245,-6573,426
TGGGCA,4.47441929166542,0.807510051139268,1.8148160629823702,1.32616197198198,6,92932,96691,90259,3759,-6432,427
AAAAAC,3.92038112541281,0.6383328903360971,1.7931369977092901,1.32612486513627,6,98437,97013,90262,-1424,-6751,428
AAAGGA,4.13078757162471,0.737353506609997,1.79820948836775,1.32544041513898,6,97014,96938,90299,-76,-6639,429
ACAGTG,4.04886159696227,0.564913389254963,1.81548806170531,1.32531776310667,6,97605,96678,90311,-927,-6367,430
TCTTCC,4.2056163304061,0.76813174416842,1.80897465714004,1.32501823172022,6,96368,96787,90335,419,-6452,431
GGGCAC,3.98370115333723,0.60054690223537,1.84979609902624,1.32495275835508,6,98033,95713,90340,-2320,-5373,432
GTCTCT,4.01576696801545,0.5786721998848969,1.8155239089951798,1.32447404522176,6,97839,96676,90373,-1163,-6303,433
CAGGGT,4.12353777373294,0.7550750339520369,1.8256928431197301,1.32383747684758,6,97070,96453,90425,-617,-6028,434
ACCCTG,4.12288571543902,0.493183727811687,1.82550210390263,1.32354707283514,6,97074,96457,90448,-617,-6009,435
AATAAT,3.5681213073393194,0.881367925452348,1.78840790763863,1.32351562620305,6,99690,97082,90451,-2608,-6631,436
AGAAAT,4.00353468765669,0.8128652845037461,1.7863545114701798,1.3234043615334399,6,97921,97108,90460,-813,-6648,437
AGGTGT,3.6970122985645,0.442271857913214,1.82685814941165,1.32339516955543,6,99362,96424,90462,-2938,-5962,438
ACTGGG,4.12209126834046,0.0549133938635524,1.8250315798280001,1.32331445170606,6,97084,96466,90469,-618,-5997,439
AGAGAC,4.017919542695201,0.8355742124238309,1.8138988078065,1.3231972453421599,6,97820,96709,90491,-1111,-6218,440
GGAGAA,4.36079125296075,0.8167469102485859,1.80052825874181,1.32310082807241,6,94643,96900,90494,2257,-6406,441
TTCTCC,4.36096091819341,0.815241632500456,1.7999171939139598,1.32268205587202,6,94640,96909,90518,2269,-6391,442
ATACAT,3.45061479300042,0.798864052347081,1.8053873876655702,1.32252105938306,6,100010,96834,90526,-3176,-6308,443
GTCTGT,3.69308948865489,0.42843828021423896,1.82409363341912,1.32128327941606,6,99373,96485,90628,-2888,-5857,444
CATCTC,4.0444621382778,0.659101258099941,1.80901855307947,1.3204155647528402,6,97633,96786,90685,-847,-6101,445
TGGAAA,4.15236939860652,0.5917974703619611,1.79043851498131,1.3203579525676001,6,96851,97055,90695,204,-6360,446
ACCTGC,3.8992621028753502,0.309159067074404,1.8302014957369501,1.3201591862842301,6,98542,96327,90713,-2215,-5614,447
TCCTTT,4.12228092238837,0.7369010470413231,1.79080761931883,1.3199078242106002,6,97079,97045,90734,-34,-6311,448
GAGATG,4.0444403575666,0.6668895948025161,1.8081199280552802,1.31987658093452,6,97635,96799,90737,-836,-6062,449
ATAAAA,3.94804029551642,0.6144443155493,1.7692484229224898,1.31890942437587,6,98254,97321,90820,-933,-6501,450
ATTATT,3.5629324707748298,0.626033701111312,1.78160397012048,1.31847578826781,6,99704,97166,90862,-2538,-6304,451
ACAGAC,3.6901651308297794,0.7167215999933991,1.8170888056083998,1.3158293405369,6,99385,96648,91055,-2737,-5593,452
AGAAGA,4.11816468312167,0.8979015274776,1.78558659986471,1.31579872955673,6,97119,97118,91058,-1,-6060,453
AAGTGA,3.79740205389745,0.723272629611254,1.79722946834207,1.31564094054266,6,99002,96954,91069,-2048,-5885,454
GAACTC,3.69060281026073,0.49140255944825,1.81614117800899,1.31523105935591,6,99383,96662,91106,-2721,-5556,455
GCATGT,3.6085840028890197,0.5597893769356489,1.81922285464473,1.3151357138804298,6,99605,96591,91112,-3014,-5479,456
GTTTTT,3.9071582182824502,0.0754646097016867,1.7781449767058501,1.3150784487582,6,98517,97222,91118,-1295,-6104,457
GAGTTC,3.6884950853311698,0.49169539370650606,1.8154945411137,1.3148425673706299,6,99390,96677,91134,-2713,-5543,458
ACAAAC,3.6363647051283596,0.7918316757712579,1.80167668349957,1.31414171505372,6,99539,96890,91183,-2649,-5707,459
ACATGC,3.6081041008969996,0.561484007491126,1.8172818646184499,1.3135751304863201,6,99607,96638,91223,-2969,-5415,460
CTTTCT,4.27210514512285,0.7850673048403589,1.7762297910399198,1.313116836714,6,95702,97249,91262,1547,-5987,461
CTGTTT,3.9523331313639902,0.29762187386817607,1.78770498106556,1.31308483382261,6,98227,97094,91264,-1133,-5830,462
ATGAAA,3.8316622987570796,0.6466108835980301,1.77848088027704,1.31307960277907,6,98853,97214,91265,-1639,-5949,463
GCCCTC,4.1257801013340005,0.679497850444051,1.82616705926225,1.3124543003301001,6,97048,96445,91315,-603,-5130,464
ATTAAA,3.5534371630619703,0.430383806548722,1.77372376336128,1.31226656769831,6,99726,97269,91334,-2457,-5935,465
TTTCCC,4.18878329140206,0.598331332013713,1.7921416181360001,1.3122208964411002,6,96525,97026,91338,501,-5688,466
GGGAAA,4.18817729781468,0.605083135459136,1.7919130613022198,1.31201103504044,6,96531,97029,91349,498,-5680,467
TCACTT,3.7916252992115496,0.7664812612666769,1.78993811189225,1.3101597852504299,6,99032,97061,91488,-1971,-5573,468
CCCCCA,4.50140055049397,0.7935239042790649,1.8068161228758202,1.3097826333923899,6,92457,96816,91516,4359,-5300,469
CTTTTT,4.220359817198379,0.388666208617614,1.7600993718372802,1.30963688729145,6,96222,97426,91535,1204,-5891,470
CTTCTG,4.18587820015647,0.7973600949991461,1.78827889407976,1.3093729854252498,6,96557,97084,91558,527,-5526,471
CCATCT,4.10973573965482,0.7219018794439208,1.7913154775133702,1.30933488336502,6,97191,97040,91562,-151,-5478,472
GCACTT,3.8351050285409904,0.780124894018242,1.80165933012442,1.3090726302328102,6,98840,96891,91576,-1949,-5315,473
CAAAAA,4.2484634682106295,0.414728600496025,1.7586758003365202,1.30896507745868,6,95937,97441,91592,1504,-5849,474
ATAAAT,3.7018936513788803,0.790620913002856,1.76411013996929,1.3089632346105,6,99346,97387,91593,-1959,-5794,475
GAGACC,4.07694569602872,0.664737657353459,1.80596799060622,1.30801239853922,6,97422,96828,91668,-594,-5160,476
TTTAAT,3.5491041703072,0.427334025055292,1.7677756696528402,1.3078843135077,6,99743,97337,91679,-2406,-5658,477
GGTCTC,4.07278333977323,0.6553354368431329,1.8052527318226599,1.3075193922965,6,97450,96837,91711,-613,-5126,478
AGATGG,4.10798840743338,0.7141300029323399,1.7887337743987701,1.30751422610812,6,97210,97076,91712,-134,-5364,479
AAACAG,3.94616260665793,0.281479265299964,1.7805301753618101,1.30737364997774,6,98270,97188,91729,-1082,-5459,480
ACAGCA,4.02723187453609,0.5412455013088521,1.7916120091441297,1.3071418986279901,6,97761,97036,91747,-725,-5289,481
GGAAGA,4.18059243111233,0.9431927389141579,1.78432819459986,1.30624644171761,6,96598,97135,91805,537,-5330,482
ATTTAT,3.6988564264734,0.723194773927172,1.75945781411014,1.30556178448266,6,99356,97433,91843,-1923,-5590,483
AAGTGC,3.82607977471694,0.782565329897722,1.7957102652883,1.30447757865097,6,98886,96984,91929,-1902,-5055,484
TTCCTC,4.17606208351812,0.657585534219038,1.77942041025206,1.30255359295524,6,96641,97206,92066,565,-5140,485
GCTCCC,4.11159330249325,0.282822520337822,1.8119802604214998,1.30181696471462,6,97176,96745,92117,-431,-4628,486
CACCTC,4.2552032049429105,0.668354322501649,1.7901891985346698,1.30173014904257,6,95877,97059,92130,1182,-4929,487
GAAGAA,4.09910010865969,0.804823668311611,1.76652202540273,1.3012444379833998,6,97280,97347,92157,67,-5190,488
GGGAGC,4.11161871310554,0.7755325796288041,1.81076800683371,1.301074733159,6,97175,96764,92170,-411,-4594,489
TTTTAT,3.92761924651711,0.59530952568173,1.7455971720158503,1.30102411545996,6,98399,97583,92177,-816,-5406,490
AGAGGA,4.1492852904912,0.7992038350052578,1.7783189036416498,1.30097984316823,6,96882,97217,92181,335,-5036,491
GAGGAA,4.17288229268636,0.656608746919549,1.77661805617389,1.30038940679274,6,96670,97242,92216,572,-5026,492
TTCTTC,4.09637963188705,0.933627652250728,1.76490632881751,1.3001318772623798,6,97299,97375,92239,76,-5136,493
TGGGGG,4.48500875848502,0.7860124952066271,1.79331850704972,1.29991492914279,6,92773,97009,92252,4236,-4757,494
TCCTCT,4.14339402194381,0.7488637663767099,1.77630581015244,1.29936894285506,6,96920,97247,92291,327,-4956,495
CAGTGC,3.89750627510837,0.472022689659383,1.79714933158389,1.2963315674273899,6,98551,96959,92525,-1592,-4434,496
GCTGTG,4.2422235978914395,0.68642049636394,1.7823546864321202,1.2959234442994598,6,96001,97158,92559,1157,-4599,497
CACTGT,4.0095300740489,0.6956397127906071,1.77652959060828,1.29578069718054,6,97879,97243,92567,-636,-4676,498
TCTTCT,4.09065037850176,0.839682135309358,1.75917707543222,1.2957594888533501,6,97342,97435,92569,93,-4866,499
TCTCAA,3.9303380044511496,0.614964558369151,1.7648818533486799,1.29553205812228,6,98374,97376,92582,-998,-4794,500
TAAAAC,3.4945896973350203,0.419712742251798,1.7664240425247402,1.29511135197694,6,99897,97351,92611,-2546,-4740,501
AGAAAG,4.24929924560047,0.917709811609906,1.75272240463703,1.29500290424212,6,95929,97500,92618,1571,-4882,502
CACAGC,4.24534406120065,0.6789558826054289,1.7809824894713202,1.29474318054834,6,95971,97176,92636,1205,-4540,503
TTGAGA,3.93322765975832,0.621802900001406,1.76303323325416,1.29437268999241,6,98352,97401,92670,-951,-4731,504
GAGGTG,4.24399169944915,0.659977049721496,1.7799863589758402,1.29424334063616,6,95985,97199,92680,1214,-4519,505
GCCACT,4.2128847210422,0.822480921864498,1.78128057373322,1.2940975920823201,6,96295,97170,92688,875,-4482,506
GCACTG,3.89308609110451,0.421446340446233,1.7935143896807701,1.29357576419952,6,98573,97006,92731,-1567,-4275,507
AGTGGC,4.21083304000766,0.796385587220511,1.7803169289165903,1.29346583014364,6,96316,97192,92742,876,-4450,508
GCCCCA,4.28932546158292,0.640256986596928,1.79255294407742,1.29319778303772,6,95514,97020,92760,1506,-4260,509
GCTGCC,4.28672505376739,0.554212123358605,1.7921988663968997,1.29300560055467,6,95548,97025,92775,1477,-4250,510
TGCTGT,4.00341746850689,0.6917734373836129,1.77266331520128,1.29292144267961,6,97924,97284,92783,-640,-4501,511
CAGCAT,3.9291908932437,0.628655519969552,1.77582511679456,1.29292035440676,6,98383,97253,92784,-1130,-4469,512
AAAAAG,4.19681308251343,0.58382043776938,1.7386245451425701,1.2928196243985701,6,96439,97677,92794,1238,-4883,513
GCACCA,3.8940914946853398,0.502072870236782,1.7922734631266002,1.29256944972496,6,98565,97023,92806,-1542,-4217,514
TCATGT,3.5332227376272702,0.542780701226569,1.7756201004802399,1.29249098730152,6,99785,97255,92809,-2530,-4446,515
GGCAGC,4.28760966670112,0.689134465353657,1.7911610722195501,1.29227371732844,6,95539,97042,92826,1503,-4216,516
ATTTGT,3.64262981625393,0.43856227950765,1.7562400368153401,1.2918805866318899,6,99523,97467,92856,-2056,-4611,517
CCACTC,3.89195313455975,0.411173954123585,1.7894826683221001,1.2905007276645701,6,98580,97068,92961,-1512,-4107,518
GGATTA,3.64976077109391,0.8700913125555692,1.7679729145451297,1.29019791308164,6,99498,97335,92980,-2163,-4355,519
TGGTGC,3.8867304286455298,0.56535825630994,1.78861981525605,1.28999704437318,6,98602,97078,92997,-1524,-4081,520
GTTTTA,3.4872842821231096,0.34417677530154495,1.75896461439341,1.2897086567861,6,99918,97437,93023,-2481,-4414,521
TGGGGC,4.2813396939777,0.7798314177880329,1.7871374296311298,1.28932592108043,6,95609,97102,93060,1493,-4042,522
GCACCC,3.9359881909017904,0.572203011420157,1.8017592135668798,1.28889973513906,6,98327,96889,93100,-1438,-3789,523
TGTAAT,3.59878978505551,0.749398300711468,1.75133528139397,1.28703955382725,6,99623,97519,93253,-2104,-4266,524
ATTACA,3.60112217759862,0.747428261625856,1.7514213438020803,1.2870391812897501,6,99620,97517,93254,-2103,-4263,525
AGACCA,3.9996406368355797,0.608383809501525,1.7640207714436102,1.28623856670638,6,97944,97389,93312,-555,-4077,526
GAGGGC,4.09176253480393,0.670902519277751,1.7909118285321,1.28619668178182,6,97335,97044,93318,-291,-3726,527
CTTTTC,4.07685049260077,0.750824977946655,1.74537718953123,1.28523250536345,6,97424,97585,93396,161,-4189,528
TGGTCT,3.99277334481052,0.602337907432634,1.76201919150491,1.2848596980770102,6,97979,97412,93431,-567,-3981,529
AGAGAA,4.2357611326944,0.8985888955000609,1.7391842917309601,1.28465210281154,6,96067,97668,93445,1601,-4223,530
TCTGTG,4.18227651195218,0.7333754357531992,1.7541661115901201,1.2843577574341,6,96585,97483,93467,898,-4016,531
ACATGA,3.5250025879496603,0.539089767792431,1.76437727554436,1.2839321309097902,6,99812,97381,93498,-2431,-3883,532
TTCTCT,4.23391868730883,0.796823919178272,1.7380433332258898,1.2839066256728702,6,96085,97682,93503,1597,-4179,533
ATGCTG,3.91478201068986,0.441333601928024,1.7636625643757298,1.28379140599632,6,98474,97396,93510,-1078,-3886,534
GTGCAC,3.54558254870772,0.389730066952719,1.7946538547988502,1.2836733466797001,6,99751,96993,93521,-2758,-3472,535
GTGATC,3.6466717180974104,0.755939072721713,1.77367117387993,1.28332633091529,6,99511,97270,93545,-2241,-3725,536
TAATCC,3.64090346071384,0.8673961124505509,1.75879168114113,1.28312833126356,6,99531,97439,93569,-2092,-3870,537
GAGTGG,3.88068656428995,0.399567627186094,1.77843952188648,1.28246473892455,6,98629,97215,93608,-1414,-3607,538
AAGGAA,4.25657246893513,0.868239041076857,1.73469777830877,1.28187145767149,6,95863,97734,93656,1871,-4078,539
GCAGCA,4.1969361981577,0.679059425498167,1.7641737569316398,1.28120320240104,6,96438,97385,93693,947,-3692,540
GTTCTC,3.64112704555611,0.318753012900348,1.76968808856264,1.28029182268476,6,99527,97318,93764,-2209,-3554,541
GATCAC,3.64415820832854,0.748523803805117,1.76969657607681,1.2802387964656101,6,99520,97317,93767,-2203,-3550,542
TCATTC,3.67773959552603,0.693976727925335,1.7532918056078899,1.2802064121092098,6,99416,97498,93769,-1918,-3729,543
GAAAAG,4.07102914910177,0.7846928349171058,1.73845106584481,1.27983174723098,6,97458,97681,93800,223,-3881,544
AAACTA,3.47421766332535,0.6269251033252261,1.74605200851506,1.27962508207194,6,99944,97578,93816,-2366,-3762,545
CAACAT,3.7074480324329597,0.7447014964994308,1.75122483181792,1.27937863487039,6,99319,97521,93831,-1798,-3690,546
TCAGGC,4.00466825445623,0.18695406898855202,1.76906528866391,1.27924301908503,6,97916,97322,93844,-594,-3478,547
ACACCC,3.71827327584381,0.354488096362182,1.78118687434301,1.27917388015986,6,99279,97172,93850,-2107,-3322,548
GCCTTC,4.0032547651502,0.6980684544679201,1.76881009327497,1.2790262771016399,6,97925,97325,93861,-600,-3464,549
GCTCCT,4.0032547651502,0.41318567011800805,1.76881009327497,1.27902610568954,6,97926,97326,93862,-600,-3464,550
CTCTCC,4.35014476889495,0.76881057448016,1.75348613589366,1.27778239921197,6,94748,97492,93952,2744,-3540,551
ACAAAT,3.6236366378613996,0.722589629104245,1.7374008713422098,1.27726441377296,6,99565,97696,93981,-1869,-3715,552
TCCCCT,4.1903787159964,0.7203253052713199,1.75812213400852,1.2766395922029699,6,96507,97446,94038,939,-3408,553
AGGAGC,4.00182258638241,0.737033420456907,1.7646580333660802,1.27596365874733,6,97933,97379,94084,-554,-3295,554
TGCTGC,4.18634662827715,0.675496245093983,1.75698881110317,1.27582688513235,6,96550,97460,94095,910,-3365,555
GAGAAC,3.63872673688485,0.621473184156343,1.7627035174091001,1.27501117470152,6,99534,97406,94157,-2128,-3249,556
CTGCAA,4.1059402033113805,0.662830924089063,1.7443234900982498,1.2748739635836899,6,97228,97595,94168,367,-3427,557
GGAGAG,4.347410327621979,0.7649776813172281,1.74875902981045,1.27436811777656,6,94777,97548,94201,2771,-3347,558
ATGTTG,3.6967090986384,0.694231947575297,1.7441933161926202,1.2742059426219199,6,99363,97596,94209,-1767,-3387,559
TTCCTT,4.2494663107231405,1.03025350726425,1.72403749516552,1.27395685401972,6,95928,97868,94228,1940,-3640,560
ATGGTG,4.09184102566421,0.704376336903909,1.7432335922613502,1.2738812230619398,6,97334,97607,94233,273,-3374,561
CAGGCC,4.45263104712732,0.687752733365407,1.7583705425331,1.27338290929025,6,93295,97445,94267,4150,-3178,562
GGGTGC,3.91307098048512,0.5691765740385489,1.7806270142083898,1.27335356060574,6,98483,97183,94272,-1300,-2911,563
AGGCCT,4.15484882164239,0.654389560706573,1.75484380483667,1.2732972509246498,6,96826,97479,94277,653,-3202,564
CACCAT,4.09366161504776,0.954960400304817,1.74248392848597,1.27313323214559,6,97324,97619,94285,295,-3334,565
CTTGGC,4.18270505206479,0.796648636767845,1.75334723489081,1.2730789363126,6,96583,97495,94287,912,-3208,566
GCCAAG,4.18442330391936,0.7928612108245671,1.7516608626932901,1.2717601188152101,6,96569,97513,94384,944,-3129,567
GGGTGT,3.70463640989226,0.39237255570171603,1.7707961074838998,1.27171952322077,6,99334,97306,94387,-2028,-2919,568
GTGTAT,3.34420623931239,0.594696281385849,1.75344875493646,1.27103927611666,6,100284,97493,94436,-2791,-3057,569
AGCAGC,4.18325131433311,0.6484622662411539,1.75048887310705,1.2708766850164799,6,96580,97527,94452,947,-3075,570
GTGAGT,3.48074273382554,0.611790209732826,1.7614131704199298,1.26963486202495,6,99931,97416,94550,-2515,-2866,571
TCTGGA,3.97643585300739,0.540125392246459,1.74167701072007,1.26950445647046,6,98075,97630,94556,-445,-3074,572
AGAGGC,4.1492201635386605,0.396674528259314,1.74805685281585,1.2682039638996898,6,96884,97558,94647,674,-2911,573
CTGTAA,3.8915484538446896,0.6476455266822561,1.72853540449992,1.26788055378412,6,98583,97812,94672,-771,-3140,574
AGGGGA,4.177168749657129,0.7072807823471691,1.74251620955208,1.2650400546571698,6,96629,97618,94871,989,-2747,575
CCCCAT,4.12825571241532,0.903500073853659,1.74466708007736,1.26502985464114,6,97028,97591,94874,563,-2717,576
TGAGGT,3.9667650217187704,0.8259222834970291,1.73485257449607,1.2643238127227099,6,98130,97731,94928,-399,-2803,577
TGGCTA,3.7361978683338797,0.786449935605672,1.7431485337286399,1.26381276651299,6,99226,97609,94964,-1617,-2645,578
AGAAAC,3.88866506043125,0.888020036108015,1.7230326291351399,1.26363414437132,6,98593,97881,94979,-712,-2902,579
ACCACA,4.00020124687505,0.680881935736112,1.7329822509798203,1.26356112104148,6,97940,97752,94987,-188,-2765,580
TTACAG,3.88975096071063,0.62213622284585,1.72250342846085,1.2634083674896899,6,98590,97890,94999,-700,-2891,581
GCCTCT,4.14035267706959,0.670764315373912,1.74150595418096,1.26321646585777,6,96952,97633,95016,681,-2617,582
TCTGGC,4.01131679560834,0.43053086883051095,1.74636102944777,1.26309018753143,6,97869,97576,95025,-293,-2551,583
TTTCCA,4.07951751838854,0.519998814568099,1.71528679089865,1.26307873935291,6,97403,97980,95026,577,-2954,584
ACCTCA,3.96785451937276,0.529838439777331,1.7333929478978798,1.26303773121016,6,98120,97748,95032,-372,-2716,585
ATGGGG,4.12385418863288,0.48552029564888105,1.7409134023427701,1.2624340315130902,6,97063,97643,95080,580,-2563,586
GCCAGA,4.01415183908776,0.6918883391485501,1.7453881555681698,1.26232325311784,6,97853,97584,95090,-269,-2494,587
TAGCCA,3.73571682058152,0.28709899463745897,1.74042115584127,1.26168611094418,6,99231,97649,95133,-1582,-2516,588
AAAACA,4.18632980792256,0.541738032675257,1.69654214004845,1.2612208600379098,6,96551,98213,95173,1662,-3040,589
GCTGCT,4.166572110894609,0.6412801036524539,1.7372142937206398,1.26090982702337,6,96729,97701,95195,972,-2506,590
TGTGGT,3.9895208134529603,0.888564963423164,1.728255565862,1.26021104967267,6,97998,97814,95241,-184,-2573,591
CTCTGG,4.32463453833839,0.623844685569672,1.72829982836104,1.25884654431087,6,95079,97813,95322,2734,-2491,592
CCAGAG,4.32581779587211,0.620801895869537,1.72684257503665,1.25767932836267,6,95065,97831,95385,2766,-2446,593
CTTTGT,3.8792462449365197,0.6751787081902378,1.7146180946380902,1.25748036294113,6,98635,97989,95407,-646,-2582,594
GCCTGA,3.9756413000372004,0.646171835781338,1.73963504093796,1.25712087535828,6,98081,97663,95434,-418,-2229,595
GAATGA,3.6501081373723503,0.6721346583518549,1.72253717300621,1.25698156431883,6,99496,97889,95447,-1607,-2442,596
AAATGC,3.8003142819949702,0.485823834772837,1.71693593964168,1.2568815764158998,6,98993,97960,95455,-1033,-2505,597
TGTTTT,4.1810414659692094,0.53998227998864,1.69026992632276,1.25678697923509,6,96596,98296,95465,1700,-2831,598
GGCCTG,4.42619961211407,0.6162389591538511,1.7341854376548502,1.2552468802127301,6,93685,97739,95559,4054,-2180,599
GCATTT,3.7991865462809504,0.478013259419706,1.7141931029739899,1.2549783854461298,6,98998,97994,95579,-1004,-2415,600
GCACCT,3.81240998550578,0.5178965392678789,1.74334937836738,1.25495001677947,6,98951,97606,95580,-1345,-2026,601
CCCAAA,4.30139974056309,0.695921474220206,1.70921369281696,1.25427344552449,6,95368,98056,95623,2688,-2433,602
GAACAG,3.7677239877862903,0.380339428105549,1.7277020106040701,1.25336184543301,6,99109,97824,95669,-1285,-2155,603
TCCAGA,3.95739761957139,0.658388295726875,1.7203924471490601,1.25333833298503,6,98188,97914,95671,-274,-2243,604
TTTGGG,4.29753637704681,0.698999469662844,1.70630548150594,1.2524095282136398,6,95417,98100,95726,2683,-2374,605
ACTAAA,3.43835023580803,0.36993265898951,1.71018458099774,1.25238911345477,6,100043,98041,95729,-2002,-2312,606
AGGTGC,3.80558079598658,0.51920980307926,1.73682298296535,1.25018040421316,6,98975,97706,95882,-1269,-1824,607
CGCCAC,3.3612969729498703,-0.0557185954228441,1.77352291324248,1.25015256925261,6,100229,97273,95885,-2956,-1388,608
TTTGTA,3.78383061443376,0.9613188239745191,1.69375264863422,1.24950906831505,6,99060,98246,95915,-814,-2331,609
GAGAGC,3.80873484111332,0.5943387125507089,1.73556904580347,1.24929686248452,6,98967,97720,95932,-1247,-1788,610
CAGAAT,3.82869129111539,0.597476360379497,1.70552243853951,1.2492780986346599,6,98876,98108,95933,-768,-2175,611
CCCTTC,4.15404159885677,0.8425755125770259,1.7217850168688797,1.2492350702405202,6,96836,97900,95936,1064,-1964,612
GCAGAA,4.07266634546889,0.624777006905203,1.7098913383386698,1.2488060434781598,6,97451,98044,95973,593,-2071,613
GTGTTC,3.43849378082758,0.36013890818462496,1.7338999766052101,1.24857221980473,6,100040,97744,95989,-2296,-1755,614
CTGCAT,3.8382117905954902,0.54919685392635,1.7176034385666998,1.2480835932490402,6,98827,97951,96027,-876,-1924,615
CTGTTC,3.7555358536537597,0.37981046926653794,1.71969484564689,1.24736054354283,6,99155,97922,96066,-1233,-1856,616
AAGCAG,4.07031485230763,0.6224255137439411,1.70753984517741,1.24702557801294,6,97464,98081,96103,617,-1978,617
TTTAGT,3.43049775374672,0.362099066788721,1.7021780860170201,1.24657627638145,6,100065,98148,96138,-1917,-2010,618
ACATTC,3.4735749684753,0.466681726250405,1.71451124329401,1.24623157344313,6,99945,97992,96165,-1953,-1827,619
TCCCAT,3.86749928651096,0.675684246645721,1.71348107538292,1.2458386297771,6,98687,98001,96185,-686,-1816,620
CTTCCA,4.10404695063978,0.810721399157833,1.70420131442806,1.24550769035352,6,97244,98123,96216,879,-1907,621
AGCAGA,4.105380399919371,0.718999292766069,1.7028148825665599,1.24451410331814,6,97234,98140,96288,906,-1852,622
ATGGGA,3.8662172608285803,0.23192004232107002,1.7109613855004497,1.24408455047101,6,98700,98031,96322,-669,-1709,623
AAACCC,3.93816650012963,0.34926289348416306,1.70852399255409,1.2440370315085099,6,98312,98068,96326,-244,-1742,624
GCCCCC,4.2700844531475,0.745894025950408,1.74090098986584,1.2439254836171698,6,95722,97644,96339,1922,-1305,625
CTGCTT,4.06643396229447,0.621709582118482,1.70320214812767,1.2438962213714,6,97491,98133,96342,642,-1791,626
GGTGGA,4.17675535550883,0.870266793812711,1.71275001503552,1.2434891002266202,6,96635,98009,96371,1374,-1638,627
TGCAGC,4.17495324403182,0.610811395571607,1.7128380024375,1.2433802612909,6,96650,98008,96383,1358,-1625,628
GACCTC,3.98918382551795,0.5979328312864279,1.7197677073194502,1.2430897171610902,6,98003,97920,96408,-83,-1512,629
GTGGCG,3.34904810143724,1.39334019272075,1.7635203718648502,1.24299579569148,6,100270,97397,96415,-2873,-982,630
GGGTTT,3.93599729813138,0.351354783032967,1.7065247006603501,1.24290978691016,6,98326,98094,96423,-232,-1671,631
GAAGGG,4.14771614772758,0.841920767049253,1.71306360762253,1.24283605210452,6,96893,98006,96427,1113,-1579,632
AGTAGC,3.68016733018671,0.874098578862366,1.71647079594973,1.2428193441970201,6,99414,97965,96432,-1449,-1533,633
CTCACT,4.25869785351506,0.917866556063974,1.6944501662899398,1.2424579370529198,6,95837,98238,96456,2401,-1782,634
CACCCA,4.3663132432227005,0.690847542783965,1.7041397613807199,1.2421253450706,6,94569,98124,96487,3555,-1637,635
ATGCAG,3.8310640016825896,0.35580151722714404,1.70929735573671,1.24184193115855,6,98859,98053,96500,-806,-1553,636
TGGAAG,4.09877672702466,0.680360979201826,1.69845753980686,1.24127905446426,6,97282,98192,96546,910,-1646,637
AGTGAG,4.25665416726375,0.92863303244803,1.69233622233947,1.24096149608488,6,95862,98267,96570,2405,-1697,638
GCTGCA,4.17126056855736,0.6132111368948531,1.7091453269630301,1.24059610824494,6,96689,98057,96595,1368,-1462,639
GGGGGC,4.26460634109712,0.7486939022388871,1.7360707238633002,1.24057714282472,6,95783,97715,96596,1932,-1119,640
TAGTTT,3.42193126203305,0.516756702796581,1.69361159430335,1.24007657326213,6,100085,98249,96633,-1836,-1616,641
GCTACT,3.6746168322315604,0.873587869210953,1.71207859191166,1.2394903296878501,6,99427,98021,96671,-1406,-1350,642
TTGCAG,4.0615769912775495,0.5863145068221078,1.6971868831936598,1.2393652948818898,6,97518,98201,96678,683,-1523,643
GCTCTC,3.7914651679060096,0.42196792265326394,1.72142254704417,1.23862485895454,6,99035,97905,96730,-1130,-1175,644
TCCACC,4.17118162641524,0.489603872863961,1.7061676200070102,1.23831010293722,6,96692,98101,96759,1409,-1342,645
GGACAC,3.66280267836647,0.469308524605442,1.7260401998895902,1.2380490103876398,6,99465,97843,96778,-1622,-1065,646
ACCATG,3.9635268525941605,0.723386189898022,1.6985541868339398,1.23759482959916,6,98155,98190,96810,35,-1380,647
CTCAGA,4.09510264095884,0.709879827722629,1.69369541752312,1.2375834502787502,6,97308,98248,96812,940,-1436,648
GTGGCC,4.05498217109778,0.550185627170968,1.7247262947084099,1.23757882745532,6,97558,97853,96814,295,-1039,649
GTGTCC,3.65834662682872,0.472412914346966,1.7241824013964298,1.23673437147495,6,99472,97861,96868,-1611,-993,650
TTCTGC,4.0562324711297295,0.611508090953741,1.69300065696293,1.23617357540551,6,97551,98256,96900,705,-1356,651
GAAGAG,4.06304729542639,0.851485512345938,1.6920809085768402,1.2356011232276298,6,97511,98270,96932,759,-1338,652
ATACAC,3.30025348853599,0.5650678367356611,1.7065738280915401,1.23556129134756,6,100377,98093,96938,-2284,-1155,653
CTCTTC,4.0591207405931,0.85472357496592,1.69203252880173,1.23548478634302,6,97534,98273,96943,739,-1330,654
TCATGC,3.66286869455032,0.616248601144447,1.7066623935349199,1.2352382488666,6,99464,98090,96959,-1374,-1131,655
ATTCTG,3.80605600432656,0.480800013567933,1.6866950691096898,1.23502645408305,6,98973,98343,96979,-630,-1364,656
GAACAC,3.4251023719317297,0.34865086173152404,1.71602480441683,1.23502389022855,6,100073,97972,96980,-2101,-992,657
GCATGA,3.6636224269171,0.6424154352321241,1.7058545386776998,1.2346653875599298,6,99463,98104,97006,-1359,-1098,658
CATGGT,3.95792787432479,0.8547256941599871,1.6944162965988303,1.2345563916626598,6,98185,98240,97021,55,-1219,659
ACAAAG,3.8500700335596605,0.6536933754583759,1.68443760226355,1.23432630108126,6,98783,98372,97040,-411,-1332,660
GGAAAC,3.92479646302396,0.861161933268425,1.69547787847234,1.23429431107129,6,98413,98228,97041,-185,-1187,661
TAATAT,3.21830656409743,0.44419499768598497,1.6796015255810801,1.23428161616284,6,100587,98427,97042,-2160,-1385,662
TAAAGA,3.57440195586546,0.287874203930084,1.67929064909432,1.23334072360123,6,99672,98432,97119,-1240,-1313,663
ATATTA,3.21696933030016,0.7609018152753979,1.6782642917838202,1.23326474284284,6,100594,98450,97125,-2144,-1325,664
CCTTTC,4.08290789948704,0.7412389505062149,1.6862662262209902,1.23190672636566,6,97387,98350,97209,963,-1141,665
ACTGGA,3.7662697539248504,0.329959293163924,1.6968949763743701,1.23104341219871,6,99113,98206,97274,-907,-932,666
GAGACG,3.10231218188046,1.3909245029052202,1.74033293425607,1.23087802813803,6,100822,97653,97285,-3169,-368,667
TCTTTA,3.56995172187415,0.747944026608273,1.67478690137335,1.23005597557427,6,99682,98497,97323,-1185,-1174,668
CACAGT,3.9537943140428102,0.7915389080145341,1.68803640618184,1.22966874040179,6,98215,98328,97353,113,-975,669
TGGGTG,4.3441936112525,0.67953070086136,1.6868367127044601,1.22929267219496,6,94829,98340,97377,3511,-963,670
CTTCTT,4.0027250611442,0.699041949955232,1.67125175807466,1.22877597867853,6,97929,98553,97415,624,-1138,671
ACATAC,3.29087365009729,0.6906706543343559,1.69719398965285,1.2285078490415702,6,100397,98200,97434,-2197,-766,672
CGTCTC,3.0959360886415297,-0.0847996146230692,1.7370800154651498,1.22839276526212,6,100833,97704,97445,-3129,-259,673
GTATGT,3.28670582346331,0.616210691840095,1.69594833908738,1.22775388984302,6,100407,98221,97479,-2186,-742,674
CAGTTT,3.8714684861419504,0.205236792041113,1.67408291142316,1.2274869432845101,6,98668,98507,97499,-161,-1008,675
TACAAA,3.75537759312736,0.575970225634093,1.66466839814648,1.22710279078628,6,99157,98652,97519,-505,-1133,676
ACAGCC,3.9656226098784195,0.113417715351121,1.69759179871028,1.2263215398749,6,98140,98197,97558,57,-639,677
TCCAGT,3.7589677487227897,0.689922796777013,1.69036931629556,1.22611577035065,6,99142,98293,97578,-849,-715,678
ACTTTG,3.8683037301651204,0.6404074746664771,1.6717033975470803,1.2256606992228898,6,98680,98547,97612,-133,-935,679
GAATGT,3.4456676041103305,0.440106490821435,1.68650337973929,1.22523225358344,6,100022,98347,97636,-1675,-711,680
CAGGAA,4.262089593601529,0.599609659711629,1.67022746887932,1.2247676345536,6,95808,98570,97651,2762,-919,681
TATACA,3.36480398112674,0.6207632249380239,1.6731732590391002,1.22343223105997,6,100217,98520,97666,-1697,-854,682
GAGCTC,3.7726284721648597,0.375582430815873,1.70102426407902,1.22339194872432,6,99099,98160,97667,-939,-493,683
TTCCTG,4.25835517688778,0.5967850619845689,1.66680035832299,1.22229643983174,6,95843,98626,97687,2783,-939,684
AAAATG,4.13315861261599,0.490813167503688,1.6456172748768798,1.22222257230933,6,97002,98873,97688,1871,-1185,685
CATATA,3.36264899822152,0.5850569255572471,1.67101827613388,1.22180002408774,6,100225,98558,97690,-1667,-868,686
GCATGC,3.6895375706532003,0.609112392443796,1.70157275854054,1.2213597617345,6,99387,98155,97693,-1232,-462,687
GGCCAC,4.03479668755756,0.5845532600967671,1.7030797231339199,1.22131111751282,6,97692,98135,97694,443,-441,688
GAAGGC,3.92897279255269,0.6208736372984089,1.6918082395363603,1.2212307357143,6,98385,98278,97695,-107,-583,689
TTTCAG,3.99328771210408,0.327056018003246,1.6606561151174501,1.22073938166358,6,97972,98704,97705,732,-999,690
GGAAAA,4.1757083276283105,0.49902952962875896,1.6538336370019497,1.22013269040944,6,96644,98787,97714,2143,-1073,691
GTTTCT,3.8299117045053195,0.34287386422282695,1.6652835542068798,1.2200300453158301,6,98865,98641,97715,-224,-926,692
TGTATA,3.35788796166695,0.672913077033087,1.6685035697143102,1.2199601425727902,6,100240,98603,97717,-1637,-886,693
TCTGCT,4.06770186222566,0.7021666097787951,1.6701025561489498,1.21975612493899,6,97481,98574,97719,1093,-855,694
TCCCCC,4.19201249283969,0.656790711918085,1.69458754065528,1.2197421251991398,6,96490,98237,97720,1747,-517,695
AAATGG,3.9412051799848395,0.38063325174028,1.66033885054282,1.21911604809908,6,98294,98712,97726,418,-986,696
TGGCAT,3.82906899948107,0.63264503932032,1.67794955316694,1.2190812254916399,6,98870,98458,97727,-412,-731,697
ACTCCC,3.7958303088932097,-0.0329404732622205,1.69335984265556,1.21842192144931,6,99012,98251,97738,-761,-513,698
GTGATG,3.74791213300578,0.662266342331343,1.6799984434895603,1.2184105245056203,6,99186,98422,97739,-764,-683,699
TCAGAG,4.03829488302389,0.414752179556235,1.6688900833983502,1.21802180237896,6,97669,98597,97745,928,-852,700
ATGCCA,3.82914592552873,0.543768922153241,1.67578014907959,1.21737881726952,6,98869,98482,97753,-387,-729,701
TGGGAC,3.98102050312393,0.676654802768375,1.6839608146114702,1.21710250647488,6,98049,98378,97756,329,-622,702
GAGGTC,3.9537438905144398,0.564642386085524,1.6846516953398702,1.21683534376554,6,98217,98367,97758,150,-609,703
GCTAAT,3.36204275757931,0.50920957886818,1.67774288811925,1.21652224687531,6,100226,98462,97762,-1764,-700,704
ATTCAT,3.47029551174235,0.530997292038469,1.6596840416706597,1.21635741836627,6,99954,98717,97765,-1237,-952,705
AAACTG,3.8538799232778,0.20071701852485396,1.65889469161344,1.21577111530967,6,98765,98729,97773,-36,-956,706
GGGATT,4.062288396018991,0.6291736313479511,1.66440905855286,1.2155056509883102,6,97514,98655,97781,1141,-874,707
GTCTCG,3.0781406552745003,1.3214085866586498,1.71928458209811,1.2153073943738602,6,100871,97931,97785,-2940,-146,708
GTCCCA,3.97982877442233,0.338133964606085,1.6816599207852,1.2152823001393602,6,98056,98408,97786,352,-622,709
CATTTT,4.12911389220143,0.48580837608585603,1.63609602241997,1.21518125938302,6,97026,98950,97790,1924,-1160,710
GGCTGT,3.9475507898681896,0.601573405857664,1.68246328367533,1.21515003384352,6,98258,98398,97791,140,-607,711
AAACCA,3.85536831762514,0.29739796654757106,1.6581367558257698,1.21513214593031,6,98751,98739,97792,-12,-947,712
AGGTCA,3.90329986883085,0.6702189351792479,1.6691410914731397,1.21461380643513,6,98526,98594,97799,68,-795,713
AAACTC,3.6641720489511402,0.187673016461439,1.66409996258551,1.2145929431621298,6,99462,98660,97800,-802,-860,714
ATGAAT,3.46914310238755,0.685329554364053,1.65697004509186,1.21433077024759,6,99958,98754,97805,-1204,-949,715
CTTTGG,4.21797481483056,0.8917004687180741,1.6572550135750401,1.21431956167602,6,96243,98750,97806,2507,-944,716
GGGCCC,4.22981702555569,0.611509459685783,1.7009574852979499,1.21430682358791,6,96129,98161,97807,2032,-354,717
TCAGGT,3.7126043088130496,0.5167358669411679,1.67560500688909,1.2141943599793898,6,99304,98485,97811,-819,-674,718
CCATTT,3.93655825640921,0.377039552588764,1.6537529029896,1.2141776151503603,6,98322,98788,97812,466,-976,719
TGGAGC,3.9474842812445496,0.647693935890777,1.68096692785997,1.2139977664122399,6,98260,98417,97814,157,-603,720
ACCTGA,3.713921187478,0.38445172322214394,1.67505750421287,1.2137036444452098,6,99295,98494,97822,-801,-672,721
GAGTTT,3.6643106342820495,0.188525069548783,1.6625229477730101,1.21369322966152,6,99460,98683,97823,-777,-860,722
GTGTTG,3.5791288440388103,0.5356224499897649,1.6796218945177002,1.21352484965408,6,99663,98426,97825,-1237,-601,723
GGGGGA,4.18340744879643,0.649833328230965,1.68506875543587,1.2128877758544399,6,96577,98363,97838,1786,-525,724
AAGAAG,3.9827298702045,0.7190004407767691,1.65015178694754,1.2126185894894501,6,98039,98827,97842,788,-985,725
ATTAGC,3.35613294255619,0.493861168933726,1.67183307309613,1.21207437602931,6,100247,98544,97846,-1703,-698,726
CAAAGT,3.84940209055795,0.934585882144683,1.65363161679284,1.2117991592419701,6,98786,98789,97849,3,-940,727
TACATA,3.3494056576393803,0.6729220024978331,1.65777493555174,1.21177310899914,6,100267,98746,97850,-1521,-896,728
TTTTCC,4.16776525282499,0.492048790933245,1.6423364372673601,1.21159433180174,6,96718,98894,97853,2176,-1041,729
ACTCTC,3.55112472447411,0.181627479221362,1.6782246794463798,1.21147139633943,6,99736,98452,97854,-1284,-598,730
ACCTCT,3.86781944018746,0.473289184620361,1.66611529313294,1.21140838006499,6,98684,98631,97855,-53,-776,731
CTGAAA,3.9795778689498698,0.32641496419692495,1.64815807961,1.2110817574272599,6,98057,98849,97861,792,-988,732
GCCCCT,4.14787589596974,0.684010360167491,1.6838608028846003,1.2108170162399499,6,96890,98380,97865,1490,-515,733
CCATCC,4.05464892362167,0.666537253071027,1.67106029128371,1.20963567504971,6,97560,98557,97879,997,-678,734
GGGAGT,3.7833780666140697,0.645895597005699,1.6811310242106101,1.20952043102154,6,99063,98412,97881,-651,-531,735
CCCCTG,4.36556717079093,0.6032137769693741,1.6732290733077901,1.2093194587351699,6,94583,98518,97887,3935,-631,736
ACTGTG,3.92360445255301,0.47470337635403204,1.6608781169278002,1.20920817007943,6,98419,98700,97888,281,-812,737
TGGTTT,3.84453464588382,0.28241436489638394,1.6493954013000403,1.20881937124455,6,98803,98837,97894,34,-943,738
CCAAAG,4.21072576440687,0.899584394790782,1.650138847164,1.2086705622436,6,96318,98828,97895,2510,-933,739
GGACAG,3.94121988389554,0.4367926806539679,1.67351299575133,1.20836818044446,6,98292,98513,97900,221,-613,740
CTCAGT,3.89365587947513,0.7641578978672071,1.66065539603451,1.20818933444921,6,98568,98705,97904,137,-801,741
TGAGGA,4.05484406609113,0.675409810236932,1.65452487887332,1.20802761420392,6,97559,98776,97908,1217,-868,742
GAACAT,3.42424925083816,0.512005797468081,1.6636239384328702,1.20790456341111,6,100077,98664,97911,-1413,-753,743
TTAAAA,4.03830442631836,0.46208498421322897,1.61688909158642,1.2074261709168799,6,97668,99058,97923,1390,-1135,744
TTTTGA,3.92913031840754,0.481422690501714,1.63171033683583,1.2072442972842599,6,98384,98980,97925,596,-1055,745
AGGGGC,4.14316897144458,0.684779946125602,1.6783195074662598,1.20681562549064,6,96924,98448,97937,1524,-511,746
ACCAGG,3.96917916780886,0.0109446953006458,1.6698731491613998,1.20645947779397,6,98113,98579,97943,466,-636,747
CTGACC,4.09846287395987,0.783784825001588,1.66464470474798,1.20625248247883,6,97286,98654,97946,1368,-708,748
CGAGAC,3.0686812402263905,-0.113664090044976,1.706701992602,1.20595513416959,6,100890,98088,97952,-2802,-136,749
AATATT,3.64917995745753,0.7958232906651992,1.62684309561883,1.20593041173924,6,99502,99012,97953,-490,-1059,750
TCCCTT,4.04851658896339,0.614078086960136,1.65187491569733,1.20588678201279,6,97608,98805,97956,1197,-849,751
CCCTGA,4.09729247429443,0.7678230100385709,1.66347430508254,1.2053735480368701,6,97295,98668,97970,1373,-698,752
CTCTGA,4.02008675616577,0.7705770774039971,1.6514369571503897,1.20481568158991,6,97804,98812,97978,1008,-834,753
CTTCAT,3.7367114399125403,0.797413220208655,1.64786159898101,1.20475271383571,6,99223,98853,97979,-370,-874,754
CCATTC,3.81283213640069,0.5322993056888471,1.65881392527264,1.20462281100486,6,98949,98730,97982,-219,-748,755
AGGCCC,4.1405222212214605,0.579738068890803,1.67534883421922,1.20447719692908,6,96950,98490,97985,1540,-505,756
AAGTGG,3.8836711312900603,0.527269120896708,1.6558136347727002,1.20445061763769,6,98618,98763,97986,145,-777,757
TTTTAA,4.03571624003226,0.462398158012539,1.6126858043466599,1.2043422393546799,6,97685,99072,97989,1387,-1083,758
TGACCT,3.88776931235204,0.6576085395348079,1.6555540710121701,1.2043208803716499,6,98596,98766,97990,170,-776,759
ACCACC,3.96667525374023,0.28509750018895,1.66704531206884,1.20422236831054,6,98131,98624,97991,493,-633,760
TAGAAT,3.3028270230104,0.349185061755477,1.64872407742361,1.20400705527101,6,100369,98841,97993,-1528,-848,761
GGTGGT,3.96172317217166,0.826433969254618,1.66612457169346,1.20380648361184,6,98164,98630,97998,466,-632,762
TATGTA,3.3365478134684996,0.7226367613887191,1.64716342151586,1.2038062127574498,6,100292,98861,97999,-1431,-862,763
GGATGG,4.04553073682946,0.645214946701291,1.6625899505393502,1.20349642304655,6,97628,98681,98005,1053,-676,764
CCTGGT,3.9616630947261,0.595725274885556,1.6657405712239701,1.2034040033173101,6,98165,98633,98007,468,-626,765
CTGTCC,3.9319383824072003,0.448634158181186,1.6665269531904099,1.20308224422553,6,98362,98627,98014,265,-613,766
GGGCCT,4.13669193978118,0.5787092653061079,1.67300076971995,1.2028132191218501,6,96978,98522,98019,1544,-503,767
CCCATC,4.12369375530712,0.645387530302125,1.6586797488988798,1.2025573230309599,6,97069,98731,98024,1662,-707,768
GGTCAG,4.09202052201892,0.761765000960924,1.65892956913787,1.2020561329754398,6,97332,98728,98033,1396,-695,769
GAATGG,3.80987688462911,0.5266037380617661,1.6546210093009799,1.20160882106632,6,98961,98775,98039,-186,-736,770
ATACAA,3.52280545551324,0.8322812422400359,1.6365696889940602,1.20061492940743,6,99817,98943,98050,-874,-893,771
GGGCCA,4.16468581153634,0.5773115012343321,1.66823721705477,1.20011618501199,6,96746,98609,98056,1863,-553,772
GATGGG,4.1191055475221,0.6477941952056949,1.6551002070487901,1.2000768306212,6,97111,98770,98058,1659,-712,773
TCTGCA,4.07196762915886,0.5810494509463929,1.6416108986618,1.19899294158276,6,97455,98900,98078,1445,-822,774
ATTCTA,3.2940563414653794,0.5529985530446789,1.64151498310258,1.19852294977949,6,100388,98902,98084,-1486,-818,775
CTTCAC,3.6914977737356,0.602392281453804,1.65419567769447,1.1979848018465602,6,99379,98781,98094,-598,-687,776
TGGCCC,4.15964293230563,0.563857600546699,1.66511674493514,1.1977369413932901,6,96789,98645,98100,1856,-545,777
TTGAAC,3.64467254770522,0.8969793406552479,1.6414237731619201,1.1976581344684099,6,99517,98903,98102,-614,-801,778
GTTTTG,3.82950396704675,0.518441309450486,1.6343647224629598,1.1974238063943798,6,98867,98966,98107,99,-859,779
TGGAAT,3.7579138563964,0.630810338773902,1.63699133395552,1.19739717459736,6,99147,98939,98108,-208,-831,780
GTGAAG,3.6917378836846297,0.6069214930788629,1.6531769945366699,1.1973665493419798,6,99378,98793,98110,-585,-683,781
TCCTCA,4.04019904972825,0.6021829701328271,1.64035341351653,1.1971948149245502,6,97657,98909,98113,1252,-796,782
GCCAGT,3.76503060431588,0.6959856523701079,1.6646736607913997,1.19703167640322,6,99116,98651,98117,-465,-534,783
TTCCCT,4.19560970668553,0.8315992900459491,1.63456598240608,1.1970158572843899,6,96448,98963,98118,2515,-845,784
TCAAAA,3.9112504318188304,0.463818132005271,1.61862223937846,1.19690374530024,6,98490,99053,98120,563,-933,785
ACTGGC,3.76391928729097,0.183133360513132,1.66434758586723,1.19676620617624,6,99120,98659,98121,-461,-538,786
TATATG,3.32685433234935,0.641879447715494,1.63746994039672,1.1964723712218601,6,100316,98931,98132,-1385,-799,787
AACAAA,4.10181370579432,0.902144098642125,1.6120260379201998,1.19643801203111,6,97261,99074,98134,1813,-940,788
CAAAAT,3.86777305834269,0.528729889145224,1.61899375165292,1.19614053451278,6,98685,99051,98141,366,-910,789
ATCTGT,3.56398254727423,0.29933133883358004,1.6419778591138,1.19602033844079,6,99701,98899,98145,-802,-754,790
ACAGAT,3.56660969287458,0.541618417147804,1.64198562276281,1.19596266490524,6,99695,98898,98146,-797,-752,791
AAGAAT,3.67750424149665,0.72386228024172,1.62432282301662,1.1955143417318501,6,99417,99028,98158,-389,-870,792
TCAGGG,4.08319103321909,0.4593085946267779,1.65010008033804,1.19541976322375,6,97386,98830,98160,1444,-670,793
ATGTCT,3.5627600274668105,0.4474229843261471,1.6407553393063798,1.19509767987921,6,99706,98906,98170,-800,-736,794
CTTCAG,4.00592003343285,0.605881491670511,1.6376735277243901,1.19440630308484,6,97906,98928,98175,1022,-753,795
CCTCTT,4.03320869955052,0.5147321502514349,1.6365670262844598,1.1943157209842,6,97708,98944,98177,1236,-767,796
TTGTAT,3.51428609076087,0.764776132834328,1.62789631132227,1.1942835013863302,6,99841,99005,98179,-836,-826,797
TTTGTT,4.09913790903642,0.8759325447302729,1.60836636938997,1.1940023883916,6,97279,99082,98188,1803,-894,798
CTCTTT,4.11592279196255,0.637875406729979,1.6200474378796101,1.19389513798348,6,97141,99045,98189,1904,-856,799
ATTTTG,3.86326518277323,0.552202525176974,1.6151171052647901,1.19340203549629,6,98714,99062,98197,348,-865,800
ATGTTC,3.40153300611825,0.49391911132493505,1.64393036897122,1.1931332947307,6,100139,98887,98202,-1252,-685,801
CAGGGG,4.34529412446875,0.580739733730752,1.65135754289845,1.19306686847183,6,94808,98814,98206,4006,-608,802
AGACAT,3.5623775988691198,0.539548887565339,1.63775352875734,1.19276954386307,6,99709,98926,98214,-783,-712,803
GTGCAT,3.4455339275792403,0.45388950265436107,1.6561727793349401,1.19272746376089,6,100023,98761,98216,-1262,-545,804
GAGTCT,3.68412802778757,0.38002730666385204,1.6467254325566998,1.19249441001874,6,99403,98863,98220,-540,-643,805
AGCAGG,4.26950532058542,0.568637083102926,1.6392548922706203,1.19246534035234,6,95731,98920,98221,3189,-699,806
GAGTGT,3.37722394872633,0.17381704490092903,1.65789438532072,1.19210115362164,6,100192,98744,98227,-1448,-517,807
TGACAG,3.8725240803815497,0.506258681456982,1.63915054512459,1.1919779381891202,6,98663,98921,98229,258,-692,808
GGCATG,4.29694910352848,0.88545892025655,1.63734587484543,1.19186516433168,6,95423,98934,98232,3511,-702,809
GAAAGG,4.02939826164683,0.6793757942066581,1.6331340251343602,1.19168822300577,6,97748,98972,98236,1224,-736,810
TCTACT,3.56593968038419,0.667658594432345,1.63515995116155,1.19104700111,6,99698,98959,98240,-739,-719,811
CATGCC,4.29614682359937,0.883478574879213,1.6362196718923998,1.1909078248007199,6,95434,98946,98242,3512,-704,812
TCTGTA,3.5950503494399904,0.665823579561859,1.63375952593202,1.19084343197351,6,99628,98969,98245,-659,-724,813
CTGAAG,4.00204412206259,0.619857219712563,1.6322360291301299,1.1903320865623301,6,97932,98979,98252,1047,-727,814
CAGAAC,3.7144608907107597,0.629581995204481,1.6428397830252799,1.19030556970639,6,99293,98892,98253,-401,-639,815
AGACTC,3.68215699938968,0.372371490643507,1.64369660943147,1.1901202560638,6,99405,98888,98256,-517,-632,816
GAGAGT,3.52376999533675,0.507977530642503,1.64920786389526,1.18988294581196,6,99816,98839,98260,-977,-579,817
CAAAAC,3.82174844636681,0.746871491283581,1.62451688456743,1.18964855236105,6,98901,99026,98265,125,-761,818
CCTCAT,3.79287392641562,0.517020839254551,1.6388557152875802,1.18959743940142,6,99022,98922,98266,-100,-656,819
AGGGAA,4.18485768249693,0.8695748834031941,1.62459468827798,1.18941911253147,6,96566,99025,98271,2459,-754,820
ACACTT,3.47264784065069,0.44750380270581797,1.6363447180682298,1.1893905430235099,6,99948,98945,98272,-1003,-673,821
CCTGTC,4.10304651692877,0.570263544317124,1.64027884065554,1.18878847710976,6,97249,98911,98288,1662,-623,822
ATGAGG,3.79269508403155,0.34523549280771004,1.63743920870343,1.1886736104705,6,99025,98933,98292,-92,-641,823
AGAGGT,3.83790431813474,0.6970615799130009,1.6353446712803,1.1883532775811,6,98829,98957,98300,128,-657,824
TTGTGA,3.6296469959211497,0.580901487135867,1.62785930941211,1.18749457408858,6,99548,99006,98309,-542,-697,825
GACAGG,4.10466063406981,0.567791154293806,1.6384089634615,1.18745954160905,6,97239,98924,98310,1685,-614,826
AAGGGA,4.0237499596193596,0.592250295901984,1.62748572310689,1.18742091185429,6,97782,99007,98313,1225,-694,827
AGTAGA,3.56287825586902,0.662741445397412,1.6293786455053,1.18674078295467,6,99705,98993,98325,-712,-668,828
GTTCTG,3.70384806472333,0.3785920739647,1.63749596243111,1.1864104236401398,6,99338,98930,98333,-408,-597,829
TCTGTT,3.9761300330143703,0.646209689289337,1.6141456356594899,1.18618997442128,6,98077,99068,98337,991,-731,830
CGCCCG,3.3223953108011,0.9902970061502092,1.70221030531753,1.18609964061053,6,100327,98146,98339,-2181,193,831
ATGGAG,3.94723142971569,0.484763133663664,1.62797679668108,1.18586169207421,6,98264,99004,98341,740,-663,832
GAGCAC,3.56329029240314,0.288992991666426,1.65707014905414,1.18570422432402,6,99703,98752,98344,-951,-408,833
AAGTGT,3.4632065514073904,0.4513226588442029,1.63144070584712,1.18569343268604,6,99972,98983,98345,-989,-638,834
CCCTCT,4.22815316236466,0.794185575527573,1.6314945293633798,1.1856888437328001,6,96155,98981,98346,2826,-635,835
AGATGA,3.7137425946451903,0.625183857691001,1.6221728725725701,1.18537119230262,6,99298,99036,98352,-262,-684,836
AAGAGG,4.02101173227866,0.504738186511846,1.62474749576619,1.18535269918934,6,97795,99023,98354,1228,-669,837
ATTCCT,3.71094627820932,0.32806493046855295,1.62209643727779,1.1852596561847,6,99308,99037,98356,-271,-681,838
AGAGGG,4.22923504199412,0.7899883479516859,1.6305837441825801,1.1851566328604,6,96138,98985,98359,2847,-626,839
AAGCCA,4.01906567941606,0.570447853472004,1.62469154178258,1.1851476122651299,6,97811,99024,98360,1213,-664,840
CAGCAA,4.01784287193474,0.521442127435373,1.6234687343012602,1.1842246460303603,6,97821,99031,98370,1210,-661,841
CTGTCA,3.86143948047472,0.5007663908864629,1.6284389970341,1.1839048719571201,6,98729,99002,98376,273,-626,842
TCATCT,3.70820860060377,0.6171447035040261,1.61935875967224,1.18318919655448,6,99318,99048,98383,-270,-665,843
AAAAGT,3.73141108721597,0.45082394017351,1.6056280475467,1.18305760716143,6,99245,99088,98388,-157,-700,844
GTGGAA,3.85516337003865,0.498761359645295,1.6273058735212902,1.18296592475178,6,98753,99009,98392,256,-617,845
GCTCCA,3.90682540858881,0.45551733682830997,1.63962331229323,1.1828992047167801,6,98519,98917,98395,398,-522,846
GGAGAC,3.90717269824062,0.655684461603192,1.63946581009641,1.18284797900386,6,98516,98919,98398,403,-521,847
TACAGA,3.5882910985994907,0.284554832852498,1.6231923577325,1.18283573508993,6,99641,99033,98399,-608,-634,848
CCTGCT,4.2527981964421,0.555613172817061,1.6256284691554799,1.18213132589441,6,95898,99018,98411,3120,-607,849
ACTTTT,3.73455199595429,0.453268746171219,1.6040776663434198,1.1821192028245702,6,99234,99093,98413,-141,-680,850
TGTATT,3.6952742301612003,0.776254524105234,1.60519626436166,1.18205007292588,6,99366,99091,98415,-275,-676,851
GTGCTC,3.5545280049032497,0.275926782535972,1.65133053681251,1.1814884564010901,6,99723,98815,98430,-908,-385,852
GGCGCC,3.50341455020904,0.0816192500236248,1.68574155763675,1.1807021929682,6,99875,98355,98451,-1520,96,853
AGTCTC,3.8287675120588194,0.475005762384225,1.6249230573637599,1.18049010586091,6,98873,99021,98454,148,-567,854
GAGCCT,3.8730827922093303,0.423957068099409,1.6370765331100903,1.18019359019164,6,98658,98938,98459,280,-479,855
CTCCAT,3.93902922936273,0.6359334058077829,1.6206089672212902,1.18017567756521,6,98306,99040,98461,734,-579,856
GGGCAA,4.05641881381011,0.7207634975620942,1.6299576534243798,1.18003991974924,6,97550,98988,98464,1438,-524,857
TTGCCC,4.058184326607259,0.6166954131247679,1.6297841422439399,1.1799788463512701,6,97542,98991,98468,1449,-523,858
TGAAAC,3.80664594804262,0.777344771174338,1.6116607163782501,1.17997362615129,6,98971,99076,98470,105,-606,859
GTCTCC,3.90108449897313,0.477467137789805,1.6356730697563402,1.1799611435880701,6,98537,98954,98471,417,-483,860
CGGGCG,3.3127612549859906,0.851804859496289,1.69290017252635,1.17943395919103,6,100345,98260,98480,-2085,220,861
TTCCCA,4.20395845345774,0.5622636436414971,1.6101573047579398,1.1792870532731201,6,96385,99080,98481,2695,-599,862
AGGAAT,3.7055250213299398,0.613422683135722,1.61395529925732,1.17915808509542,6,99332,99069,98483,-263,-586,863
GGGTTC,3.74109154446616,0.43543490247634203,1.64040608928669,1.17904287147479,6,99212,98908,98486,-304,-422,864
TCTTTG,3.9656109823208396,0.737714726822206,1.6036265849659601,1.17820308505587,6,98141,99094,98503,953,-591,865
TGGCTT,4.0080068103173,0.6575653037421889,1.61426390186516,1.17750743417359,6,97892,99067,98512,1175,-555,866
CACTCC,4.2485756696571,0.63448405082196,1.61915961223546,1.17719325902846,6,95936,99050,98518,3114,-532,867
AATCCC,4.0089353156423595,0.5761119145927789,1.6139087433299801,1.17702998005011,6,97883,99070,98520,1187,-550,868
TTCCCC,4.24505053914712,0.7927640484186659,1.61883844467115,1.17693301565602,6,95976,99052,98522,3076,-530,869
ATGCAT,3.46177418623719,0.5783867742358679,1.6194042050682398,1.17684942057348,6,99977,99047,98524,-930,-523,870
CTGGAA,4.1658233816464705,0.502263538553251,1.60671868134462,1.17586341206182,6,96734,99086,98543,2352,-543,871
ACTGAG,3.85112748817245,0.296478127371731,1.61775395291549,1.17585912952372,6,98775,99056,98544,281,-512,872
TTGCTG,4.00563564259235,0.515958544072021,1.6118927341402,1.1757174827065,6,97909,99075,98549,1166,-526,873
GAACCC,3.7396901240947207,0.42808529912646703,1.6356580706330701,1.1753257910835901,6,99216,98955,98555,-261,-400,874
AACAGA,3.9637915443974,0.615798740836695,1.59961433063718,1.17496526418294,6,98153,99104,98560,951,-544,875
ATGCAC,3.4231576680495,0.424410233284137,1.6323354317709398,1.1748096647261999,6,100079,98977,98561,-1102,-416,876
GCTTCC,4.051202915272451,0.613718329034766,1.62280273090913,1.17473688129453,6,97590,99035,98568,1445,-467,877
AGGCTC,3.86514227072241,0.416762692547525,1.6295393049300801,1.17454105124715,6,98704,98992,98573,288,-419,878
ATTCTT,3.6497369961571495,0.34605388496818495,1.5965020639474499,1.1744965414042499,6,99499,99112,98574,-387,-538,879
ATAATA,3.37240437678792,0.7616711721335959,1.5926909770872302,1.17405962465915,6,100201,99120,98579,-1081,-541,880
GAGACT,3.8220744289082598,0.475034760429519,1.6162650936822798,1.17401712841039,6,98899,99060,98580,161,-480,881
GGGCAT,3.81588579965779,0.596939605386057,1.63043300045641,1.17388558146636,6,98931,98986,98583,55,-403,882
TCAGAA,3.9299098815020197,0.565164600314789,1.59889338546906,1.17366859746977,6,98376,99105,98589,729,-516,883
GTTCAA,3.6084116827136703,0.6776884251066999,1.6098006843823,1.17365826766136,6,99606,99081,98590,-525,-491,884
TCTGAG,4.00704289518377,0.45239353438305796,1.6082852951899698,1.1730575195686899,6,97899,99084,98604,1185,-480,885
GGAAGC,4.04690949705302,0.9129601437834258,1.62044833666729,1.17290062271811,6,97619,99043,98607,1424,-436,886
TGTCAC,3.6871582507380802,0.598172288139919,1.61934506041161,1.1726893847475601,6,99396,99049,98613,-347,-436,887
TGTAGT,3.4093828129391497,0.613362786889017,1.6149371422022802,1.17235445013175,6,100121,99065,98619,-1056,-446,888
GGAGTG,4.24019437131299,0.6284089246399761,1.6121902731331998,1.1721386829646399,6,96021,99073,98624,3052,-449,889
CCATGG,4.0041437024989905,0.439291626307965,1.62087899318495,1.17207239838443,6,97918,99039,98626,1121,-413,890
GTGACA,3.68795587328818,0.60006375247873,1.6177958536369499,1.17158016686078,6,99393,99055,98633,-338,-422,891
ATGCCC,3.8128345538676602,0.37134564038517,1.6270578316423498,1.1712487085132701,6,98948,99010,98641,62,-369,892
AAATTT,3.7565812735496302,0.201342717675651,1.57617430000203,1.1708119366944498,6,99149,99156,98646,7,-510,893
TAATAA,3.3675358530277095,0.42648029943352295,1.5878224533270202,1.17035495862396,6,100212,99130,98656,-1082,-474,894
AAGCAA,3.9190926665085,0.8561174684665541,1.5947059629708702,1.17026814005074,6,98448,99116,98658,668,-458,895
TATTAT,3.36880737366515,0.758537132754364,1.58747887301079,1.1702519239586298,6,100208,99132,98659,-1076,-473,896
GCAGCT,4.01757838253113,0.5324590342919411,1.6175733657254099,1.1700429415323998,6,97826,99057,98665,1231,-392,897
TCAGCT,3.97134948821103,0.555605266689859,1.60310298250258,1.1683119158458302,6,98105,99095,98699,990,-396,898
ACCCTC,3.72794950968199,0.281667258792037,1.6254790434443402,1.16769186798374,6,99256,99019,98713,-237,-306,899
TTCCAG,4.15796783040003,0.48972513303637294,1.59576581220348,1.1676593441128702,6,96801,99113,98714,2312,-399,900
ATGAAG,3.69030042750714,0.6407152892163399,1.5987307054345101,1.16765197626414,6,99384,99106,98715,-278,-391,901
GTGGAT,3.6018206653787797,0.48642701616976003,1.6149715300457599,1.16735755773824,6,99618,99064,98718,-554,-346,902
AGCAGT,3.84002041113414,0.6870921340999261,1.60586163377643,1.1669269344191002,6,98823,99087,98727,264,-360,903
TTGTGG,3.8348885733611695,0.47687146201414005,1.6054159758901398,1.1666574194772399,6,98842,99089,98729,247,-360,904
CAGTCT,3.8382117905954902,0.343664940104205,1.60521130715487,1.16641543094308,6,98828,99090,98731,262,-359,905
TTATTA,3.3627447884497594,0.7416388525733649,1.5814162877954,1.1656390124475,6,100224,99146,98744,-1078,-402,906
AGCTGC,4.01134675426395,0.529849171449039,1.61134173745823,1.1653688037818302,6,97868,99078,98749,1210,-329,907
GGGGAA,4.2269093513788905,0.785581395691144,1.6029602039044397,1.16501837789788,6,96169,99096,98756,2927,-340,908
AATACA,3.6734718564453703,0.751742856510857,1.58276266146449,1.1647764878945701,6,99431,99142,98758,-289,-384,909
CAACAG,3.83692544414114,0.500938373134167,1.60130557874917,1.16341338110657,6,98836,99099,98788,263,-311,910
CTGTTG,3.8310862885954906,0.500761627240815,1.6003321352898798,1.16280794801521,6,98858,99103,98798,245,-305,911
CCTGTG,4.25634385798778,0.5286477400774,1.59866303641581,1.16267117471541,6,95866,99107,98803,3241,-304,912
TGGGAA,4.17780952329259,0.580887716862296,1.5881937287053898,1.1626569966287499,6,96624,99129,98805,2505,-324,913
CACAGG,4.26033540655731,0.527868038571564,1.5984858477392598,1.1625149367723302,6,95823,99108,98808,3285,-300,914
ATGAGC,3.5660873027292204,0.376870475111659,1.60831941448982,1.1614626143080602,6,99697,99083,98824,-614,-259,915
TTGCTT,3.9101600478353196,0.825337721337132,1.5825431423903502,1.16137024844223,6,98500,99143,98828,643,-315,916
GCTCAT,3.56392829864155,0.641774677392164,1.6077219976261499,1.16098117609663,6,99702,99085,98840,-617,-245,917
ATTCCA,3.7094075729990603,0.510047939964194,1.58780030764718,1.1600987845494901,6,99312,99131,98856,-181,-275,918
CTGGTC,4.0342616980991695,0.49787389634384005,1.6023290391352,1.15952660795933,6,97696,99097,98866,1401,-231,919
AGCTGA,3.96098430809607,0.710316335417211,1.59117621516361,1.15934869141342,6,98171,99122,98868,951,-254,920
TGTGGC,4.06036838864458,0.643800879062297,1.60049947718526,1.15895085018842,6,97525,99102,98875,1577,-227,921
CATCAC,3.67100495209701,0.579772659363842,1.60094543163553,1.15881328647228,6,99439,99100,98878,-339,-222,922
TCATGA,3.5185608784689504,0.555778432935927,1.5925515013268101,1.1587938708663301,6,99831,99121,98879,-710,-242,923
AGACTG,3.8281714278849197,0.341722046875491,1.5947978926279598,1.1585812880375599,6,98877,99115,98880,238,-235,924
AAAATT,3.9745433219599597,0.39832387985483103,1.5531279872280201,1.1584313049861998,6,98083,99203,98885,1120,-318,925
GTGAAT,3.35667488732035,0.43435090493372797,1.5975106629493099,1.15826286015691,6,100243,99111,98889,-1132,-222,926
GGAAAG,4.14302932953668,0.832211882944513,1.58276633531773,1.15776315372718,6,96928,99141,98897,2213,-244,927
GAGGGT,3.71384737164437,0.49159101998655796,1.6116003292409,1.1575760502516101,6,99296,99077,98900,-219,-177,928
ATGGAA,3.85978047573479,0.6220023256285,1.57891414629278,1.15735230704675,6,98736,99152,98903,416,-249,929
ACTACA,3.3932911229169305,0.594232986638898,1.59513803401079,1.15731785114527,6,100155,99114,98904,-1041,-210,930
TAAAAG,3.63285880183656,0.360454851598663,1.57374873735895,1.1572278539866698,6,99544,99159,98910,-385,-249,931
GGGGCC,4.34250513541953,0.798778799859768,1.61615760807307,1.1570385142036799,6,94856,99061,98914,4205,-147,932
GCATTC,3.55785038362759,0.515662969874946,1.60164408261219,1.15643021964393,6,99719,99098,98928,-621,-170,933
GGCCCC,4.34175567474634,0.789009828123463,1.61508422437595,1.1561232716274699,6,94863,99063,98931,4200,-132,934
TGCAGA,4.01658450224471,0.6008505947231589,1.5846661845236498,1.15600730888821,6,97833,99136,98933,1303,-203,935
GACCAG,4.03255568373239,0.491538541436295,1.59757922060341,1.1559107728720501,6,97716,99110,98934,1394,-176,936
AATTTT,3.9721549884684197,0.398836906448701,1.5491245527828201,1.1555024104976699,6,98099,99222,98938,1123,-284,937
CTTTCC,4.14075888294106,0.814160613804647,1.5797151586616103,1.1554977079992599,6,96947,99150,98939,2203,-211,938
GATGGA,3.8255815069279397,0.746777856193805,1.5892610774166203,1.1545493838966798,6,98888,99127,98961,239,-166,939
TACAGT,3.3878605180979,0.51453616370619,1.5911685172260202,1.1544184979724499,6,100165,99123,98964,-1042,-159,940
GCCAAC,3.7068799525971903,0.6462622691697281,1.60506192103845,1.15243469128347,6,99325,99092,98990,-233,-102,941
TTCCAT,3.8550114315385495,0.7846825499377831,1.57220607811894,1.15233442434208,6,98755,99160,98993,405,-167,942
CAAAGA,3.93354092422727,0.6470131722918921,1.56936371046704,1.1520188630267,6,98347,99163,98999,816,-164,943
GTATAT,3.22336074686349,0.45331569367748903,1.5795944295629099,1.1515988018213201,6,100567,99151,99005,-1416,-146,944
TCCATC,3.82010104461863,0.7064625424602671,1.58465745942031,1.15095838225563,6,98910,99137,99023,227,-114,945
GCAAGA,3.7846238208321603,0.631712410457308,1.58584757140842,1.15089143753443,6,99055,99134,99025,79,-109,946
TAAAGT,3.30252727404791,0.38771106563464597,1.5758227072718898,1.1507622204847099,6,100371,99157,99029,-1214,-128,947
ATATAC,3.2235852842307504,0.7361501948914141,1.5783578788959098,1.15058456247051,6,100566,99153,99034,-1413,-119,948
CGCCCA,3.4154156915036804,-0.0678272165769496,1.6298297216836297,1.1505206300567299,6,100101,98989,99035,-1112,46,949
GTTCCT,3.6264031354559303,0.243521787715158,1.59056212744905,1.15031287015678,6,99556,99124,99040,-432,-84,950
TCTAGA,3.35415521733572,0.137315028814809,1.58621595190248,1.1499514633514099,6,100254,99133,99042,-1121,-91,951
AGGAAC,3.63000062759787,0.610863581779254,1.5899786504156501,1.14984558350872,6,99546,99126,99047,-420,-79,952
GCCACA,4.05283688424325,0.6296756606451961,1.5884753125139202,1.1497986047656399,6,97570,99128,99048,1558,-80,953
CAACAC,3.49847333529868,0.452291888218166,1.5937978795740402,1.14897939735344,6,99892,99118,99063,-774,-55,954
GGAAAT,3.84871876564763,0.594363209239184,1.56785243620562,1.14897649860873,6,98787,99165,99064,378,-101,955
ATTCAC,3.3440995725858302,0.420986127326264,1.5850358474045403,1.1487769124761,6,100285,99135,99066,-1150,-69,956
CAACCT,3.8146712382859302,0.6159328429413461,1.5802096668110601,1.14752290581567,6,98938,99148,99085,210,-63,957
GTTGGC,3.6960872302768903,0.641278018764448,1.5979766168874199,1.1473113750885,6,99364,99109,99088,-255,-21,958
CTTTTA,3.61949745842558,0.47638995160401293,1.55993058691138,1.1468766617598,6,99577,99184,99102,-393,-82,959
ACTGTA,3.37697185363005,0.448218331811193,1.58106509485892,1.14680812795719,6,100193,99147,99104,-1046,-43,960
GAGATA,3.35143480175733,0.440703615847324,1.5819339491000899,1.14676895380234,6,100263,99145,99106,-1118,-39,961
TATCTC,3.34836424767417,0.41965049993852005,1.58198656946493,1.14674290081688,6,100276,99144,99107,-1132,-37,962
TTCTCA,4.085676179434141,0.7257647243640691,1.55704340093086,1.14669853146759,6,97372,99187,99108,1815,-79,963
ATTAAT,3.17599748206125,0.486412536170073,1.5611822252554097,1.14625093209148,6,100687,99178,99113,-1509,-65,964
GAAACA,3.92508639402417,0.6071509493362459,1.5609091802639499,1.14560999629877,6,98409,99180,99122,771,-58,965
CCTTCT,4.12670369037233,0.7343812895260892,1.5656599660928798,1.14487302952641,6,97037,99169,99135,2132,-34,966
CATTTA,3.6483103430808197,0.6291431723812,1.5559860471462699,1.1445975992503201,6,99506,99189,99141,-317,-48,967
GTCTTC,3.6186671655106606,0.458385182020448,1.5828261575037899,1.14451431296933,6,99580,99140,99144,-440,4,968
TGGGCG,3.40348547468925,0.942529079199552,1.6204697580281398,1.14382872028749,6,100134,99041,99157,-1093,116,969
GAGGAT,3.7324447355310397,0.45717955094857,1.57718886020291,1.14338369068233,6,99239,99155,99161,-84,6,970
AGAAGG,4.123705056710279,0.7284294694642081,1.56344206249133,1.14315571266385,6,97068,99175,99162,2107,-13,971
TATTTG,3.6435316491576897,0.7151125576693629,1.5534536833581498,1.14273314736485,6,99521,99200,99163,-321,-37,972
TTTGAG,4.07914901727096,0.603363452537689,1.55160427498559,1.14264345213649,6,97406,99213,99164,1807,-49,973
TAAATG,3.640924902359,0.43561742928801395,1.55246203751313,1.1418241883569,6,99530,99206,99165,-324,-41,974
CCAGAC,3.85140962305712,0.477338132721881,1.5833788118889902,1.14077391013015,6,98772,99139,99166,367,27,975
AAAGAG,4.04660116311046,0.572363951120067,1.55002432214702,1.14054210766364,6,97621,99220,99167,1599,-53,976
GTTTCA,3.7540261501621,0.585973550856362,1.5566405754433101,1.13853624419007,6,99164,99188,99168,24,-20,977
GAAATG,3.9133546093231,0.59766549477018,1.5514237256978798,1.1384816882087299,6,98480,99215,99169,735,-46,978
GTCTGG,3.84516046550508,0.47561781652085794,1.58007295931222,1.13847816094783,6,98802,99149,99170,347,21,979
AGGTTG,3.79970719639556,0.596974690977548,1.56779474917286,1.1383600132308,6,98995,99166,99171,171,5,980
CATTTC,3.91539095622473,0.6061329530200761,1.55116022873485,1.13835165007642,6,98469,99217,99172,748,-45,981
CACCCC,4.27246489534544,0.7518060714748008,1.5778804677272902,1.1378203542291698,6,95699,99154,99173,3455,19,982
ATTCAG,3.6485223706631404,0.4144758759230421,1.5585142358145299,1.13725833914303,6,99504,99186,99174,-318,-12,983
CCACTT,3.7977415516325097,0.44795748006614,1.56648394310329,1.13718950436195,6,99001,99167,99175,166,8,984
TCTGGT,3.63811746540988,0.5603128130333989,1.57176536311766,1.13708197738677,6,99537,99161,99176,-376,15,985
ACTCTT,3.56273184376544,0.39302067217633596,1.5610446564461398,1.13698131321796,6,99707,99179,99177,-528,-2,986
TCAGCA,3.96094631341136,0.47495994018412396,1.55994238328256,1.1365356125162,6,98172,99183,99178,1011,-5,987
TCACAA,3.5607207115631097,0.539475852925795,1.56064862519748,1.1365177909753899,6,99713,99181,99179,-532,-2,988
GTTCAC,3.2896964519887297,0.40496580645672403,1.5836415597320903,1.13620561126183,6,100400,99138,99180,-1262,42,989
ACTCAT,3.3272397130442597,0.40638034342374896,1.56817598786297,1.1361228026108798,6,100314,99164,99181,-1150,17,990
AGCTGT,3.76728421605897,0.484992985303945,1.56588286312161,1.13608840694519,6,99110,99168,99182,58,14,991
ACCAGA,3.6416268930772597,0.34261756923274206,1.57000578539177,1.13564625997843,6,99525,99162,99183,-363,21,992
AGCCCA,4.19441160672639,0.5505450367909179,1.5638372553876698,1.13559184696456,6,96460,99172,99184,2712,12,993
TGATGT,3.5129066004025096,0.528464647869795,1.56039081795673,1.13537016392054,6,99847,99182,99185,-665,3,994
TCTTGC,3.7635492859963,0.619195329640844,1.5647195228428998,1.1351558675459799,6,99124,99171,99186,47,15,995
ACAGCT,3.7664568405870895,0.350712619065916,1.56359439961548,1.1342853863548799,6,99112,99173,99187,61,14,996
ATGAGT,3.3244811742510403,0.5148635203853761,1.5653169498800001,1.13409506223503,6,100322,99170,99188,-1152,18,997
TAATGA,3.23513915296552,0.320569381486186,1.55419789315251,1.1333129027374298,6,100529,99195,99189,-1334,-6,998
ACTTTA,3.2818925910660397,0.571609506532095,1.55211183530209,1.1329490734511398,6,100417,99211,99190,-1206,-21,999
TGGGCT,4.18670208977887,0.552550273673065,1.5598562855161597,1.13274603701122,6,96542,99185,99191,2643,6,1000
ATCTGC,3.6841472720857698,0.38800879162584295,1.56353892005698,1.13219834870321,6,99402,99174,99192,-228,18,1001
TCATTA,3.2372356813883703,0.5897998998983239,1.5524329904866698,1.1320844070701002,6,100521,99207,99193,-1314,-14,1002
AGGCAA,3.9179873724204,0.48427776305222603,1.55521236529018,1.13201284752117,6,98458,99192,99194,734,2,1003
TTTTCA,4.02022457881393,0.376919062698356,1.52720670903247,1.13190640675556,6,97802,99299,99195,1497,-104,1004
ATTTCA,3.7848164954761403,0.5587739534740811,1.53442208783269,1.1318825923527098,6,99054,99269,99196,215,-73,1005
TTGCCT,3.9180751516170798,0.39324499005737,1.55484333745028,1.13187909643329,6,98457,99193,99197,736,4,1006
TCTTGT,3.55372714057269,0.44100373647326097,1.5535010412876498,1.1313809447049799,6,99725,99199,99198,-526,-1,1007
CCAGAA,4.1083117162056,0.44168411979562106,1.5477247989627299,1.13118295960972,6,97207,99227,99199,2020,-28,1008
GTGAAC,3.28330996732298,0.5073220201659759,1.57569348784235,1.1303204739861201,6,100413,99158,99200,-1255,42,1009
CGGCCT,3.41838473450621,0.0137841641853846,1.6007117419339199,1.13019881695229,6,100096,99101,99201,-995,100,1010
ATCTCT,3.79712497772825,0.36003020959769605,1.5438730857833303,1.13018237981389,6,99004,99236,99202,232,-34,1011
TGCCAG,4.18415006064014,0.449781360269318,1.55582203943643,1.12963253185269,6,96572,99190,99203,2618,13,1012
GAAGAC,3.60258069369674,0.744698354704362,1.56255871651452,1.12930358381772,6,99614,99177,99204,-437,27,1013
GGCCAA,4.1796780463787595,0.7813862413013779,1.5554049758803898,1.12915206222683,6,96610,99191,99205,2581,14,1014
CACACC,4.21571177670815,0.7985453437565029,1.5535382948661598,1.12859452883014,6,96277,99198,99206,2921,8,1015
TTCTGA,3.8721807258561896,0.658285955816254,1.53914583556265,1.12856385757759,6,98665,99248,99207,583,-41,1016
ACAAGA,3.55114300006557,0.43352576121846603,1.54950932647594,1.12816034147575,6,99734,99221,99208,-513,-13,1017
ACATCT,3.4753803991441696,0.361186127420225,1.55191462294949,1.12809049412501,6,99941,99212,99209,-729,-3,1018
AGAGAT,3.79623048603846,0.700066610028461,1.5406620062593601,1.1277955479683301,6,99009,99241,99210,232,-31,1019
CCCAAG,4.18389646748859,0.5400298975531099,1.55332211614986,1.12769125885231,6,96574,99202,99211,2628,9,1020
GGGGTG,4.25494895012968,0.745879890481092,1.5632586986943897,1.12717204732717,6,95879,99176,99212,3297,36,1021
TGAAAA,4.00866538263108,0.36631993751878406,1.52112404489198,1.12702467475207,6,97887,99314,99213,1427,-101,1022
TGCTGA,3.94633657391976,0.666315800872646,1.5471756806190402,1.12698985643348,6,98268,99229,99214,961,-15,1023
CTGGCA,4.18122408566664,0.44767680847756697,1.5521319512689298,1.1268785627282298,6,96593,99210,99215,2617,5,1024
TTCCAC,3.78351487421974,0.433730802653376,1.55225726569053,1.12650135543924,6,99062,99209,99216,147,7,1025
CTCTAC,3.7540297011083,0.715016600217966,1.5523255540537801,1.12580338820535,6,99163,99208,99217,45,9,1026
GCAGAT,3.67602905076864,0.46914807338929293,1.55426240482276,1.12526426182275,6,99422,99194,99218,-228,24,1027
ACAGTA,3.3191429864522797,0.45222182243440295,1.55258902804941,1.12461544328921,6,100335,99205,99219,-1130,14,1028
AGGCCG,3.4106867767138302,1.05742506652843,1.59301378414154,1.12452341904071,6,100115,99119,99220,-996,101,1029
AAAGAC,3.7047714273134704,0.782319194502671,1.53913899601736,1.12436425883421,6,99333,99249,99221,-84,-28,1030
CCACAA,3.77869698248629,0.430528011873594,1.54905447491075,1.1239280590096101,6,99077,99223,99222,146,-1,1031
AGAGCA,4.104152874312129,0.69699320302194,1.53758859925284,1.12372752433058,6,97242,99257,99223,2015,-34,1032
TCATGG,3.7045965786429704,0.43651446556309603,1.55090229053885,1.12362683654164,6,99335,99218,99224,-117,6,1033
GTTTCC,3.77804265671791,0.482261421653929,1.5482461362229498,1.1235715641183701,6,99080,99226,99225,146,-1,1034
GTAGAG,3.7509398641679,0.707784821082559,1.5483802173134598,1.1229676380321398,6,99176,99225,99226,49,1,1035
TGTCTT,3.89140565361381,0.675403247386152,1.52942125625893,1.12194537175993,6,98585,99291,99227,706,-64,1036
ACTGCT,3.7780159436934797,0.415766438121493,1.54580070235361,1.1217334489154198,6,99081,99232,99228,151,-4,1037
GGTGTG,4.20136532748953,0.765515250926383,1.5440084289414902,1.1216594986960902,6,96398,99235,99229,2837,-6,1038
TGAGAT,3.81620175867508,0.767577288636289,1.53128047852773,1.12146310537438,6,98926,99286,99230,360,-56,1039
ATCTCA,3.8170128405747,0.531327843822441,1.5310035242094198,1.12117474061874,6,98922,99287,99231,365,-56,1040
AAGACA,3.8926150326505695,0.6873023632046421,1.52843781889034,1.12101578735819,6,98575,99297,99232,722,-65,1041
TTGAGG,3.937030505567,0.419141858846519,1.53915116810086,1.12096962240233,6,98319,99247,99233,928,-14,1042
ACTTTC,3.54136716172005,0.34887345046358803,1.53967997440075,1.12089430728673,6,99761,99245,99234,-516,-11,1043
CCATGA,3.7028695728481096,0.443317164203931,1.54728977449606,1.12084476643255,6,99343,99228,99235,-115,7,1044
CTGAAT,3.6270634141339904,0.40736892000311004,1.53665198597846,1.12078294836358,6,99553,99260,99236,-293,-24,1045
CCCACA,4.20530048824304,0.5298347878042979,1.54312700640105,1.1207704496138602,6,96371,99238,99237,2867,-1,1046
GTCTTT,3.69747030042196,0.386888897481022,1.5328421501235199,1.1198306550256298,6,99361,99274,99238,-87,-36,1047
ATGTTA,3.21849376775599,0.6472069590733089,1.5359374069892902,1.11965232404015,6,100586,99263,99239,-1323,-24,1048
TTCTGG,4.0927327430053,0.427557798958404,1.53201294174977,1.11955902585034,6,97328,99280,99240,1952,-40,1049
CTTGGG,4.16855525034056,0.5344034342347629,1.54170944607786,1.11911320765095,6,96712,99239,99241,2527,2,1050
ATGGCA,3.88905859533413,0.6016478210254289,1.5382048317962598,1.11898003933804,6,98592,99253,99242,661,-11,1051
CAGACA,3.9696938820239103,0.551713644367348,1.5355292341678402,1.11890189354575,6,98111,99264,99243,1153,-21,1052
CCAAGA,3.9332111855616403,0.5419543582275871,1.53662302602525,1.1188023649078702,6,98353,99261,99244,908,-17,1053
AGCCCC,4.21639214379711,0.7273324504297329,1.5534068466822202,1.11875683519122,6,96266,99201,99245,2935,44,1054
GCCTCG,3.18301745916118,1.17837969443621,1.5945909647748797,1.11874358940419,6,100672,99117,99246,-1555,129,1055
TAACAT,3.21771562241056,0.386573983749935,1.5345280324625301,1.11849016581615,6,100592,99268,99247,-1324,-21,1056
CAGTTC,3.61503298932975,0.22778716833751,1.54643455690252,1.11804209476488,6,99587,99231,99248,-356,17,1057
TGAAAT,3.76266886721205,0.542646663690849,1.5161358906572802,1.1178851863343302,6,99129,99327,99249,198,-78,1058
CAGGAC,3.85069984816159,0.48077602034642397,1.5513938295141203,1.11777004625027,6,98776,99216,99250,440,34,1059
CTCCTT,4.090238235785351,0.544518950092391,1.5291945115059,1.117333522121,6,97344,99292,99251,1948,-41,1060
TTGTCT,3.6937124210411203,0.578375377900462,1.52908427074268,1.11699498408109,6,99371,99294,99252,-77,-42,1061
AGAAGC,3.89767719652512,0.6998895963677829,1.5349021893949,1.1167287609043999,6,98550,99267,99253,717,-14,1062
GTTCTT,3.5342199733813597,0.230536862192395,1.53399387409632,1.1166950333873602,6,99782,99270,99254,-512,-16,1063
CCAAGG,4.16216671644056,0.632315819677803,1.53789364594218,1.1160014573813601,6,96766,99255,99255,2489,0,1064
AGATGT,3.45858134752559,0.342434976302998,1.5354183654480702,1.11579113220248,6,99984,99265,99256,-719,-9,1065
TGCCAT,3.88265742282923,0.746202538221288,1.5337260664024401,1.1155714071426799,6,98620,99272,99257,652,-15,1066
CGAGGC,3.1798253721238305,-0.572720263155517,1.5901612135374499,1.1155283973323,6,100681,99125,99258,-1556,133,1067
CCTAGG,3.7760763719969703,0.275617111061157,1.55088177439183,1.1155004200938,6,99088,99219,99259,131,40,1068
GGGGCT,4.20994750843664,0.7313895430733891,1.54876835128668,1.11548661488454,6,96325,99224,99260,2899,36,1069
AAGAAC,3.5340567214295397,0.6912875921542071,1.53242304783991,1.1152998839061101,6,99783,99276,99261,-507,-15,1070
TCTTGG,3.92795423443371,0.537518797055824,1.5316364841915802,1.11528230380711,6,98394,99284,99262,890,-22,1071
GTCCTC,3.65470498780958,0.337706618048104,1.55369560960619,1.1142881740800101,6,99485,99197,99263,-288,66,1072
GGACAT,3.5323198168545096,0.5030337199236049,1.54400959348723,1.11414699892122,6,99790,99234,99264,-556,30,1073
TACTGT,3.30214055960846,0.454919125278721,1.53820598315693,1.11389469661377,6,100372,99252,99265,-1120,13,1074
CTACAG,3.7391042694261496,0.435874622839531,1.5362418284545298,1.11375577765504,6,99219,99262,99266,43,4,1075
GTCTGC,3.6214340376183505,0.325295557158427,1.5538345185142202,1.11354864196816,6,99573,99196,99267,-377,71,1076
GAACTG,3.60944634653684,0.23358222346111104,1.5400715689863702,1.11329098316681,6,99601,99244,99268,-357,24,1077
GATCTC,3.58060659314493,0.39084360117681505,1.5407608961563501,1.1130571182321598,6,99659,99240,99269,-419,29,1078
GAGGAC,3.6552338839954595,0.43151644430338704,1.55152575355773,1.1127284282094498,6,99483,99214,99270,-269,56,1079
GCCTTG,3.9689178269859906,0.468818371004973,1.5395600098120201,1.11243229623138,6,98114,99246,99271,1132,25,1080
TATAGA,3.0282580621947797,0.264340400940672,1.5322252283168798,1.1121913379957,6,100956,99278,99272,-1678,-6,1081
TGTCTG,3.95453807837265,0.5584917316404351,1.52642767801059,1.1121378217677,6,98210,99303,99273,1093,-30,1082
GCTTTC,3.7327713129026603,0.540277601646196,1.5339415497492501,1.11205499257728,6,99235,99271,99274,36,3,1083
CCTTGG,4.15818267500785,0.622722234643758,1.5322945035558,1.11196425417692,6,96799,99277,99275,2478,-2,1084
AAGCTG,3.9191638527864505,0.431101855219799,1.5270360452879799,1.11159379402824,6,98447,99302,99276,855,-26,1085
ATCCTC,3.6889307988969504,0.3719324291354699,1.5349125877688998,1.11153386892795,6,99388,99266,99277,-122,11,1086
TAACAA,3.2515813721830695,0.259804791417059,1.5234157173727803,1.11115012572241,6,100480,99308,99278,-1172,-30,1087
TTGTTA,3.2508955040588794,0.633808150802418,1.52257583632918,1.11075657799617,6,100486,99311,99279,-1175,-32,1088
CAAATA,3.6019647750104395,0.442245452726738,1.51125558002956,1.11051354018495,6,99617,99341,99280,-276,-61,1089
GAGCAA,3.73073615137342,0.586339259289071,1.53195990194969,1.11043356317814,6,99250,99282,99281,32,-1,1090
TTCAGT,3.7166877223687296,0.622804649482637,1.51930214764994,1.11033766644275,6,99284,99318,99282,34,-36,1091
GAAAGT,3.5256941258484398,0.5717633093653621,1.5255215402930702,1.1101887257199299,6,99810,99304,99283,-506,-21,1092
TAATTA,3.1279868345003803,0.47377508283146397,1.5131715776945298,1.1098856043816399,6,100779,99332,99284,-1447,-48,1093
ATCCAC,3.52698916583415,0.419828556405795,1.5383550194429498,1.10981563208894,6,99803,99250,99285,-553,35,1094
CTGTAG,3.7322432373083996,0.449952006553373,1.53084188437104,1.10978731059257,6,99240,99288,99286,48,-2,1095
ACTGAA,3.7135490431447797,0.607079931755752,1.5185638114804099,1.10960363006751,6,99299,99321,99287,22,-34,1096
TTGGCC,4.1549871460253796,0.650190602098563,1.5290989745733299,1.10956624497874,6,96825,99293,99288,2468,-5,1097
ACCCCC,3.8846509440485604,0.47414550673335,1.5526100566010002,1.1092052039324198,6,98610,99204,99289,594,85,1098
TAACAG,3.2985406019626002,0.244181434945524,1.53198664355972,1.1091726891704599,6,100382,99281,99290,-1101,9,1099
GTTCAT,3.28963660975638,0.35033839005249606,1.53203397260934,1.10910859656249,6,100401,99279,99291,-1122,12,1100
TGTGGG,4.184540484833359,0.5198775744422189,1.52718358628532,1.1090201748498998,6,96568,99301,99292,2733,-9,1101
CTGCTA,3.50043212448563,0.456401318156543,1.53789388416573,1.10891787328916,6,99887,99254,99293,-633,39,1102
GTCCTG,3.8342240390076,0.254187615307421,1.5383015155054798,1.1080394435907701,6,98844,99251,99294,407,43,1103
AAGGAG,4.077144642339859,0.493072308477439,1.51688164812091,1.10800232288506,6,97421,99324,99295,1903,-29,1104
CAAGGC,3.9654195369174703,0.461722493453449,1.53265709569141,1.1072266679756202,6,98143,99275,99296,1132,21,1105
TTGCTC,3.7260284809889703,0.572367691897545,1.5271987178355602,1.10699821414438,6,99261,99300,99297,39,-3,1106
TCTATA,3.01958569071731,0.25628799821523396,1.52511444406342,1.10682148957853,6,100966,99305,99298,-1661,-7,1107
TAGAAG,3.45630922970596,0.19257980027822402,1.52280961934223,1.10651076775597,6,99994,99310,99299,-684,-11,1108
CAGCTT,3.9158619144957996,0.417846069042755,1.51987267590864,1.10630623199207,6,98467,99317,99300,850,-17,1109
ACTTCT,3.6809751137737594,0.43000687058135906,1.5148858754410601,1.1062064965073701,6,99409,99329,99301,-80,-28,1110
GTCCCT,3.8021497197313,0.43813930309171994,1.5367382905145202,1.10601762035146,6,98987,99259,99302,272,43,1111
AGACAA,3.6803221569187303,0.623185797437191,1.51468972562262,1.1059199520491,6,99413,99330,99303,-83,-27,1112
GAAGCA,3.92163621883014,0.701210339667167,1.5190707014773202,1.10579495694539,6,98429,99319,99304,890,-15,1113
GCCATG,3.9911168782173996,0.570201984754352,1.5290016366230699,1.10530465353257,6,97989,99295,99305,1306,10,1114
ATTTCC,3.79273437526332,0.49695314019934705,1.50992902184371,1.10523099689274,6,99024,99342,99306,318,-36,1115
GTCCCC,3.8776954023059904,0.45755240101807504,1.5471156028926798,1.10521865299495,6,98639,99230,99307,591,77,1116
ACTTCC,3.75500278766174,0.317518201424065,1.52374517913253,1.10510036098873,6,99158,99307,99308,149,1,1117
CATGGC,3.9902896505644603,0.571475810847167,1.5281744089701297,1.10468562294902,6,97992,99298,99309,1306,11,1118
CTACTC,3.5670035101065296,0.670814592015002,1.5297014140653997,1.10466262428073,6,99694,99290,99310,-404,20,1119
GAATTT,3.5586936853887896,0.280753911192026,1.5038971659550802,1.10427903207557,6,99717,99354,99311,-363,-43,1120
GAGATC,3.56996793219494,0.38733031472959206,1.52856064798235,1.1039634417625601,6,99681,99296,99312,-385,16,1121
GCAGAC,3.61065216314012,0.455318930651172,1.54043326208464,1.1035218956421,6,99594,99242,99313,-352,71,1122
CTCAAA,4.02646310329706,0.549964070807359,1.4994454257474399,1.10282497650184,6,97766,99364,99314,1598,-50,1123
GTTCCC,3.6385393162156006,0.309026895070039,1.5375299380122098,1.10226254636724,6,99535,99258,99315,-277,57,1124
TCTTCA,3.8675882411389906,0.649339504776323,1.5033575136491102,1.10216438446459,6,98686,99355,99316,669,-39,1125
ACTGCC,3.8272333978935804,0.0947204674847928,1.52984978635719,1.1016474418089999,6,98880,99289,99317,409,28,1126
TCCTTG,3.9111258533238704,0.534456008723664,1.5135265472471597,1.10163310810455,6,98492,99331,99318,839,-13,1127
ATGAAC,3.28178121078177,0.534088003731796,1.5211558983764801,1.1009099594078702,6,100418,99313,99319,-1105,6,1128
CATCTG,3.94178945175636,0.5434967748891419,1.5114327212593002,1.10079036924585,6,98286,99340,99320,1054,-20,1129
ATGCTA,3.23992797788979,0.628018011716566,1.52175670840127,1.10035265094101,6,100513,99312,99321,-1201,9,1130
GGGGAC,3.8716382212349503,0.72286637162194,1.54024517983524,1.10025901710919,6,98666,99243,99322,577,79,1131
TCAAGT,3.5106623638523597,0.7302572661188801,1.512051365521,1.10002797241272,6,99853,99337,99323,-516,-14,1132
CCAAGT,3.74470739692577,0.6735769147641711,1.5165259773844901,1.09960201124505,6,99200,99325,99324,125,-1,1133
ACAATA,3.23516365935686,0.571088916528579,1.5069980045465703,1.09878190665382,6,100528,99348,99325,-1180,-23,1134
TTTAGA,3.39812835472911,0.0096033225986556,1.5014019470043103,1.0987245958340799,6,100147,99359,99326,-788,-33,1135
TAGCAG,3.48787385759214,0.0924053712920898,1.52417732335516,1.09869640943111,6,99915,99306,99327,-609,21,1136
CTTCTA,3.44324574376906,0.683066263042855,1.51246601454642,1.0986891949816,6,100028,99335,99328,-693,-7,1137
TTTGGA,3.8616712034924303,0.46668878573484207,1.49812521891354,1.09829415202973,6,98727,99370,99329,643,-41,1138
ACCATC,3.59012465328647,0.4764861511281121,1.5200651328249999,1.0982280908262199,6,99637,99316,99330,-321,14,1139
TTGAAA,3.78449761420585,0.5349345026601071,1.4886927335878102,1.09813583139428,6,99057,99397,99331,340,-66,1140
TATAGT,2.9267377061283097,0.48294639004665096,1.5161576078678798,1.09807017988806,6,101090,99326,99332,-1764,6,1141
CCTGCA,4.17233535627465,0.442392908229262,1.51240820456768,1.09776550222272,6,96672,99336,99333,2664,-3,1142
AAAGCA,4.02081871727481,0.7011937831564321,1.4926427458081002,1.09768681269176,6,97797,99381,99334,1584,-47,1143
ACCAAA,3.6999134211767,0.504150520170684,1.50268185937733,1.09756475274692,6,99353,99357,99335,4,-22,1144
TGCTTT,4.01852149630086,0.702482696335853,1.4921350479325801,1.0974890994984101,6,97813,99384,99336,1571,-48,1145
ACTATA,2.92491027297797,0.4767487159217971,1.51548846863463,1.0974220091420102,6,101092,99328,99337,-1764,9,1146
TATTGT,3.23298978086006,0.5731889040274311,1.5046701131303601,1.0972661154883498,6,100538,99352,99338,-1186,-14,1147
AAGCAC,3.5508659175514197,0.46809162807691795,1.5190353200885298,1.09647817893254,6,99738,99320,99339,-418,19,1148
TTTGGT,3.69592204652048,0.5996409336097409,1.50078280193669,1.09642531101678,6,99365,99362,99340,-3,-22,1149
AGCTAC,3.71482778167923,0.914781299790318,1.5119653407076201,1.0955536482096402,6,99291,99339,99341,48,2,1150
GGGGGT,3.86301505019424,0.7157042886154928,1.53308309682879,1.0950377131763198,6,98718,99273,99342,555,69,1151
ATGTAA,3.38091686704208,0.487304620425419,1.49614218855716,1.09441480963446,6,100183,99374,99343,-809,-31,1152
TTACAT,3.38386278599332,0.4894885832019699,1.49601191852046,1.0943957388734398,6,100175,99376,99344,-799,-32,1153
TAGATA,3.0038550448201002,0.437242866540673,1.5078222109422,1.0938773745913801,6,100989,99344,99345,-1645,1,1154
GATGGT,3.58103960794005,0.6734353159849941,1.51312591842383,1.09321597016853,6,99657,99333,99346,-324,13,1155
TGCAGG,4.16559177965191,0.435370741801163,1.5059885509688602,1.09304837876025,6,96737,99350,99347,2613,-3,1156
TATCTA,3.0011721057121803,0.685581959077737,1.50670085905828,1.0930064918750502,6,100994,99349,99348,-1645,-1,1157
CAGATG,3.9328573880349795,0.5171234805134259,1.50093907031391,1.09292667942261,6,98357,99360,99349,1003,-11,1158
GGAAGT,3.73525650515235,0.799910815751119,1.5073990086349898,1.0928600034917502,6,99232,99347,99350,115,3,1159
GGCAGT,3.81532388350899,0.620981454728472,1.51747895289578,1.09254599402143,6,98935,99323,99351,388,28,1160
GAGTAG,3.55158212022138,0.6727305277485451,1.51302123107341,1.09233187194335,6,99732,99334,99352,-398,18,1161
AAGAGC,3.70651443288059,0.589156839872222,1.50773818345685,1.0922774092457699,6,99326,99345,99353,19,8,1162
AGGGAC,3.7852043437031204,0.762477650684128,1.51749745555892,1.0917156699464798,6,99052,99322,99354,270,32,1163
TAATGT,3.1798225864576803,0.339982404360653,1.49888132664466,1.09171480086705,6,100682,99367,99355,-1315,-12,1164
GGGAAC,3.62689530085903,0.487951743216392,1.5231871704213,1.0916550692748601,6,99555,99309,99356,-246,47,1165
TATCTT,3.3870293840467993,0.637846554673219,1.4918645635460002,1.0914941876747801,6,100167,99386,99357,-781,-29,1166
GTGCTT,3.54400079056836,0.452853197155298,1.51201618018606,1.09148504802643,6,99755,99338,99358,-417,20,1167
ACTTGA,3.5037781167263997,0.5925636712442139,1.5005293421831,1.09147925130457,6,99872,99363,99359,-509,-4,1168
TCTAAA,3.3848231659410697,0.00126945367663645,1.4912734463939301,1.09089312410668,6,100171,99387,99360,-784,-27,1169
TGAGAA,4.0091332131599104,0.648190978801095,1.48320357182822,1.09058878014281,6,97882,99413,99361,1531,-52,1170
GTAGCT,3.7064707926912797,0.9078853988366279,1.50506943975393,1.09046658161523,6,99327,99351,99362,24,11,1171
AATAGA,3.3853710463292,0.43186277756367797,1.4902597395580601,1.09015705345458,6,100170,99391,99363,-779,-28,1172
AAAAGC,3.8126767313061802,0.33348592039536,1.48829002776855,1.08972983280803,6,98950,99398,99364,448,-34,1173
GGCGGA,3.36278801869782,0.0365356771804208,1.54543894914946,1.08961428226603,6,100223,99233,99365,-990,132,1174
TCTATT,3.38451936845975,0.431602502813178,1.48935454795894,1.08959935713362,6,100173,99395,99366,-778,-29,1175
ACATTA,3.1808648553482004,0.51029869923395,1.49606216444651,1.08957292330108,6,100679,99375,99367,-1304,-8,1176
AGAAGT,3.6566376689260798,0.657453732637102,1.4924663256642199,1.08924688260986,6,99477,99382,99368,-95,-14,1177
ATTCCC,3.6582787601125197,0.32876633896696994,1.5042605489844798,1.0885756982734,6,99473,99353,99369,-120,16,1178
GAAAGC,3.70128545139673,0.548750971045287,1.50250920197299,1.08835932471483,6,99348,99358,99370,10,12,1179
AAATTC,3.53465559646392,0.258402913698545,1.48303576520789,1.08830751702365,6,99780,99415,99371,-365,-44,1180
TCCGCC,3.36171236916148,0.0425940260056894,1.54371545356527,1.08824665941809,6,100228,99237,99372,-991,135,1181
CTGTTA,3.26681852095055,0.227420222673967,1.50288394449901,1.0874385578781,6,100444,99356,99373,-1088,17,1182
ATGTCC,3.4948161736812002,0.47962343904908894,1.5076431153242498,1.08696239100981,6,99896,99346,99374,-550,28,1183
ACTTGG,3.72989428673077,0.523631365113875,1.49896060122548,1.08661717846535,6,99253,99366,99375,113,9,1184
ATTTGA,3.53530508578624,0.5048604319939191,1.4805085663525301,1.08657474262005,6,99777,99421,99376,-356,-45,1185
GCTCTT,3.6978381236536095,0.528126952064509,1.49900836050021,1.08586994980858,6,99359,99365,99377,6,12,1186
ATTTGC,3.5752934633888596,0.514651885723289,1.4903000200818997,1.08580660610911,6,99669,99390,99378,-279,-12,1187
CCCACT,4.12675463808911,0.484046362070719,1.4973385806674702,1.08565915444923,6,97036,99371,99379,2335,8,1188
AGACCC,3.7766190104236204,0.354428927521669,1.50858819925549,1.08497163282161,6,99085,99343,99380,258,37,1189
CTTTGC,3.8556581089304798,0.7268717499067231,1.4924262947636797,1.0849428906308398,6,98749,99383,99381,634,-2,1190
CAACTC,3.57093911949954,0.42428040691588903,1.5008795990380601,1.08388511903125,6,99677,99361,99382,-316,21,1191
ATGTCA,3.44583571520004,0.48223603448752395,1.49107360261926,1.08320437949874,6,100021,99388,99383,-633,-5,1192
TTTCAA,3.76319061907924,0.523920049970437,1.46894732568521,1.0831099375705,6,99127,99465,99384,338,-81,1193
TAGCAT,3.22005059454359,0.37739607419970506,1.49847470100298,1.08302150776561,6,100579,99368,99385,-1211,17,1194
GAACAA,3.49106913595788,0.499292555191873,1.48943546236825,1.08298315852355,6,99906,99394,99386,-512,-8,1195
TGCCCT,4.120525636902951,0.728314439880748,1.49335590961632,1.08273445499824,6,97100,99379,99387,2279,8,1196
TCAGTG,3.8869002688822203,0.40295206117491106,1.4881426688884198,1.0825706717746,6,98601,99399,99388,798,-11,1197
TGTAAA,3.56251053347271,0.279650638506602,1.4740476686268402,1.08239086061678,6,99708,99453,99389,-255,-64,1198
ACATCA,3.44613101353001,0.45429006610407,1.4899078129149699,1.08225124141617,6,100019,99392,99390,-627,-2,1199
ATACAG,3.4143154753331695,0.369888153737561,1.4896914052213999,1.08137751767041,6,100105,99393,99391,-712,-2,1200
TTGTTC,3.48715141929893,0.533736979931831,1.4869253200138899,1.0813056118344,6,99919,99403,99392,-516,-11,1201
TGACAT,3.4413575980505002,0.48085739225198104,1.48738072757047,1.08041456006893,6,100031,99401,99393,-630,-8,1202
ACTAGA,3.18456016657315,0.282856113498157,1.4957416974528899,1.08009832846541,6,100669,99377,99394,-1292,17,1203
AGTGGG,4.11713755268734,0.481827442664446,1.48913345450755,1.07969099286082,6,97133,99396,99395,2263,-1,1204
GCAAAG,3.8481984265330897,0.6518217684318021,1.4854234194028701,1.07954477033674,6,98788,99409,99396,621,-13,1205
GGCACA,4.1492587749862,0.7324162650584809,1.4874092161681398,1.07905255658754,6,96883,99400,99397,2517,-3,1206
AAATCA,3.7138291705653703,0.45262878259895706,1.4650498638756,1.07904161828264,6,99297,99481,99398,184,-83,1207
CTGTAT,3.40815227549506,0.378048388875586,1.48614758733463,1.0787777740937599,6,100124,99407,99399,-717,-8,1208
ACCACG,2.95444773514987,0.888856241282086,1.53140530550041,1.07873806479255,6,101047,99285,99400,-1762,115,1209
GCTTCT,3.84649434785409,0.5955261046616899,1.48326253368729,1.0780607033438299,6,98796,99412,99401,616,-11,1210
GCAAAA,3.79699615379632,0.31780534288549894,1.4726094502586897,1.07788925667034,6,99005,99456,99402,451,-54,1211
TTGCAT,3.56457219476636,0.681184782765037,1.4795787514593997,1.07774250892504,6,99700,99425,99403,-275,-22,1212
AGGGCA,4.1167178151538595,0.6801809219999799,1.48646738683906,1.07763226808659,6,97135,99404,99404,2269,0,1213
TGTGCC,4.143165190800721,0.716782889625488,1.4854843692287498,1.0776308829372099,6,96925,99408,99405,2483,-3,1214
TTTTGC,3.79933128218211,0.32142673040301895,1.47171437673714,1.07751763606869,6,98996,99460,99406,464,-54,1215
GGGTCT,3.76333624761597,0.350378576127097,1.4982487414231003,1.07743743317346,6,99126,99369,99407,243,38,1216
GACGGG,3.1273154604826403,0.19935557645296997,1.53765130189626,1.07719269279227,6,100784,99256,99408,-1528,152,1217
TTGTTG,3.67038937810982,0.6558315532954581,1.47525013352604,1.07717849240643,6,99444,99445,99409,1,-36,1218
ACCACT,3.7209214339645698,0.487894604765826,1.4864598624896899,1.07716725253569,6,99273,99405,99410,132,5,1219
AGTCCC,3.9254555250616097,0.454243820419441,1.4920406491566398,1.0768929763722601,6,98408,99385,99411,977,26,1220
CAACAA,3.67235351108406,0.670833502530662,1.47512194928469,1.0767937066005502,6,99435,99447,99412,12,-35,1221
TCAAAT,3.5189899498821,0.493880891659643,1.4673701186260801,1.07645850984995,6,99830,99472,99413,-358,-59,1222
CAAGGA,3.8825975989698196,0.500917012980617,1.4800320816170098,1.07644794772162,6,98621,99423,99414,802,-9,1223
TGACAC,3.3988895407770596,0.343557191333037,1.49646041518743,1.07639835564996,6,100144,99373,99415,-771,42,1224
CTGGAC,3.7634744144431203,0.392470677424635,1.496925820216,1.07636771973646,6,99125,99372,99416,247,44,1225
TGCTTC,3.87739561867076,0.650396561090478,1.47979631259405,1.07627937172211,6,98641,99424,99417,783,-7,1226
TGATGG,3.82988334495495,0.567729359143783,1.4812759115520902,1.0762645539495799,6,98866,99420,99418,554,-2,1227
AGCCAT,3.80137707609004,0.690347366236104,1.48179852003151,1.07579142580055,6,98991,99419,99419,428,0,1228
TGAAGA,3.83021130129965,0.627144961988737,1.46828041767444,1.07558581706575,6,98864,99470,99420,606,-50,1229
TAATTC,3.13083487435517,0.46490636593067297,1.4782935159923798,1.07550584557162,6,100771,99433,99421,-1338,-12,1230
ACCTTC,3.52775561427702,0.250001495665034,1.49045351823589,1.07533963798536,6,99800,99389,99422,-411,33,1231
AAAAGG,3.98509554949205,0.308416751492507,1.4632208588657,1.07530429396618,6,98027,99485,99423,1458,-62,1232
TGTGGA,3.9067779779501097,0.6346227691412429,1.47710599036405,1.0750662682899,6,98520,99438,99424,918,-14,1233
CCTCAA,3.8732575412937598,0.35639609294834795,1.47823096898137,1.0748701052385,6,98657,99434,99425,777,-9,1234
CACTGA,3.8791760603511696,0.596908957169056,1.47776883691545,1.07472809202155,6,98636,99436,99426,800,-10,1235
TGTTTC,3.82875142461881,0.521739751549159,1.46676702726393,1.0745653110129,6,98875,99475,99427,600,-48,1236
CCATCA,3.83035689385887,0.564876357945987,1.4791792072970802,1.0745335835932,6,98863,99429,99428,566,-1,1237
GTGTCA,3.39518688852104,0.331884310677045,1.4934336088649198,1.07424745431186,6,100151,99378,99429,-773,51,1238
TGATTT,3.7064399780508595,0.44961936461028496,1.45829190054243,1.07411616273479,6,99329,99504,99430,175,-74,1239
ATGGCT,3.79738441831159,0.35600798721282706,1.4792880791940701,1.0739867091563,6,99003,99428,99431,425,3,1240
GCTTTG,3.87048637378406,0.642590118285426,1.4767434653319198,1.0739476869565099,6,98672,99440,99432,768,-8,1241
GCTTTT,3.7944372268357998,0.316532675056717,1.46682032139083,1.0738232028355699,6,99017,99474,99433,457,-41,1242
GTCCAG,3.7595360849982407,0.331706483689889,1.49296636186437,1.07342026760497,6,99138,99380,99434,242,54,1243
TGGAAC,3.5557270872306095,0.5749596048377329,1.48635230968014,1.07312630590972,6,99721,99406,99435,-315,29,1244
CCCGTC,3.12010675500754,0.19220591246850896,1.53168026062124,1.07267374090298,6,100794,99283,99436,-1511,153,1245
CAAGAC,3.71590323717733,0.723463570270672,1.48028337178536,1.07256141643492,6,99290,99422,99437,132,15,1246
CCAGTG,4.10772452081905,0.373355820448229,1.4793964996153401,1.07229487085808,6,97213,99427,99438,2214,11,1247
ATATTC,3.27894347079152,0.622946807788489,1.4683320007198302,1.07172626097416,6,100423,99469,99439,-954,-30,1248
ATTTGG,3.7476618233508394,0.48953225859654204,1.46518039295515,1.07154678821269,6,99187,99479,99440,292,-39,1249
GTCTTG,3.709450320272,0.698658331600702,1.47869616696639,1.07149232983596,6,99311,99431,99441,120,10,1250
GTACAT,3.0794304262593197,0.46419536435633896,1.48721185384913,1.07136842749214,6,100868,99402,99442,-1466,40,1251
CCCCAA,4.10302902489246,0.652357635117673,1.47843203137016,1.0713133364332699,6,97250,99432,99443,2182,11,1252
TCTGAC,3.55148491031173,0.5157357736150989,1.4836717199852498,1.0710921937302902,6,99733,99411,99444,-322,33,1253
GAATTA,3.12628053895295,0.463653723975428,1.47217759336615,1.07094129858281,6,100786,99458,99445,-1328,-13,1254
CGTGGT,2.9416440616450203,-0.11925772708535799,1.52038664305374,1.07088231248145,6,101073,99315,99446,-1758,131,1255
AGGACA,3.8744945239183504,0.492813937929141,1.47192900656553,1.07036275105449,6,98651,99459,99447,808,-12,1256
AGTGGT,3.7090109427011,0.637407893039564,1.4770984954783999,1.07031641019978,6,99316,99439,99448,123,9,1257
GAAGCC,3.91808335772673,0.6652465327875949,1.48310689459775,1.07025480800639,6,98456,99414,99449,958,35,1258
AAGCAT,3.5522754264703704,0.63370919382599,1.4688970841170799,1.06955394725274,6,99728,99466,99450,-262,-16,1259
GAATGC,3.4429669606426097,0.40577529509769394,1.48519907240321,1.0694692322837198,6,100030,99410,99451,-620,41,1260
ATGTAC,3.0745501883711803,0.47349404782925797,1.4823316159609898,1.06773121949874,6,100876,99417,99452,-1459,35,1261
GTTCCA,3.5475329558535997,0.34817332281874,1.4789345234263798,1.0675746762410698,6,99746,99430,99453,-316,23,1262
AAGAGT,3.46879390312299,0.598557182357673,1.4686213175676102,1.06743290297432,6,99959,99467,99454,-492,-13,1263
CACTGG,4.1015028409371,0.3679555637480229,1.4724107065393899,1.06708094162445,6,97264,99457,99455,2193,-2,1264
TGTCCT,3.8647843101725203,0.488114465572316,1.46718500409581,1.06680917122649,6,98708,99473,99456,765,-17,1265
TGCCCC,4.17477220411478,0.6563597103791551,1.48243410663164,1.06665723784622,6,96653,99416,99457,2763,41,1266
ATGATA,3.1205429285200097,0.5557475331233149,1.46643998293322,1.06663135119056,6,100793,99476,99458,-1317,-18,1267
CTACTA,3.24055985255061,0.779847361890548,1.47516418806482,1.06662368089166,6,100509,99446,99459,-1063,13,1268
TAGTAG,3.2398182605356403,0.5294770723824821,1.4747253901670199,1.0663962469038901,6,100514,99450,99460,-1064,10,1269
AAGGCA,4.05259525578939,0.525420667170401,1.46073313106718,1.06637269496485,6,97576,99496,99461,1920,-35,1270
TTTACA,3.54503907737741,0.25915996204391895,1.4527147814428703,1.06634426149103,6,99753,99519,99462,-234,-57,1271
ATGCAA,3.54737956099001,0.579189473778195,1.46400121863672,1.0658743810967,6,99747,99483,99463,-264,-20,1272
TAGGAA,3.5851302091687596,0.19679678131049105,1.46233399143564,1.06559463010431,6,99647,99490,99464,-157,-26,1273
GTCAGA,3.5463291106612904,0.487221761818043,1.4761690910100702,1.06554123471991,6,99749,99442,99465,-307,23,1274
GGGACT,3.91003987674042,0.44131020334754795,1.4765456305524498,1.06543789259744,6,98503,99441,99466,938,25,1275
ATTCAA,3.5040272292009504,0.5733039715939828,1.45240739794493,1.0651468803613,6,99871,99520,99467,-351,-53,1276
GGCTTC,3.9069180959331,0.645585685465573,1.47498543696914,1.06424232035697,6,98518,99449,99468,931,19,1277
AGTCAC,3.51389052617285,0.454257363942947,1.4754301362146398,1.06414942866938,6,99842,99444,99469,-398,25,1278
CATCCT,3.86328199857351,0.484365823838296,1.4634363623617899,1.0639364799102902,6,98713,99484,99470,771,-14,1279
TCTTGA,3.6271614488957598,0.54202567906473,1.45852860961562,1.06386293216599,6,99552,99503,99471,-49,-32,1280
GCTAGA,3.28199892157636,0.16241085598668398,1.48230114504586,1.06329118493723,6,100415,99418,99472,-997,54,1281
TGCCTT,4.04801848395886,0.7037225683808829,1.4564636653940701,1.06327345361504,6,97612,99507,99473,1895,-34,1282
ACCAGT,3.38118735259911,0.312142400653341,1.47797298490874,1.06265493797277,6,100182,99435,99474,-747,39,1283
TATTCT,3.50792113574796,0.547899244707633,1.44835426423376,1.06237361567832,6,99863,99530,99475,-333,-55,1284
TCATAT,3.26624378454275,0.613424630466568,1.4556323144710601,1.06216376976353,6,100446,99511,99476,-935,-35,1285
TATCAT,3.11301853036405,0.51815350687068,1.46047717200126,1.0621240431927,6,100802,99500,99477,-1302,-23,1286
TTTAAC,3.18746927503336,0.212035165011065,1.4576885192694,1.0618377811802,6,100663,99505,99478,-1158,-27,1287
TAGAGC,3.27912500244921,0.161767409440849,1.47942722591871,1.06115686818676,6,100422,99426,99479,-996,53,1288
TCAAGA,3.6219363979230694,0.527449533700171,1.4549186595965902,1.06099292304131,6,99571,99512,99480,-59,-32,1289
GAAACC,3.85594597445918,0.505599583995085,1.45935781492279,1.06073204633427,6,98747,99502,99481,755,-21,1290
CTCACA,4.0499627112567405,0.676373989385308,1.45295759961128,1.06059205459288,6,97601,99517,99482,1916,-35,1291
GTGGTA,3.30612490303837,0.3488013655382539,1.47734587941425,1.0604745428481,6,100365,99437,99483,-928,46,1292
GAGTTG,3.53687112253031,0.38547215393818796,1.46895743301409,1.0602195375747199,6,99772,99464,99484,-308,20,1293
TCAAGC,3.6621307418690003,0.661711936793372,1.46491607966927,1.06018941255949,6,99468,99482,99485,14,3,1294
GGGGCA,4.16748004647011,0.656164656686517,1.47354346489981,1.0601804954250502,6,96721,99455,99486,2734,31,1295
ACTGGT,3.3753448213586004,0.29754016898212393,1.47437678380323,1.06003979796809,6,100197,99452,99487,-745,35,1296
CTGGAT,3.7787466635555202,0.35619518164663894,1.460650324438,1.0600122370854201,6,99076,99498,99488,422,-10,1297
ACCAAC,3.37919306923833,0.535225626422731,1.4745176135137001,1.0600007607003499,6,100189,99451,99489,-738,38,1298
GGGATG,3.9318879185436,0.43264715086538,1.46788257807029,1.0597786819687,6,98363,99471,99490,1108,19,1299
GTTGGT,3.37307460083565,0.6033551391424941,1.4735676513145302,1.05952033337111,6,100199,99454,99491,-745,37,1300
TTGGGG,4.08772097300881,0.44938708002481,1.46215672458069,1.05948527109676,6,97361,99491,99492,2130,1,1301
TAAATT,3.45670662004461,0.484504458750991,1.43436975820591,1.0592074428282499,6,99993,99585,99493,-408,-92,1302
AGAATA,3.50301190252797,0.608889245023228,1.4439018380503499,1.05888000616434,6,99879,99545,99494,-334,-51,1303
TACCAC,3.3056650117227595,0.235521414813903,1.47510097704045,1.0586178995158,6,100366,99448,99495,-918,47,1304
CCTTGT,3.69085474163973,0.4331063345540921,1.46105822114477,1.0582116889175899,6,99381,99493,99496,112,3,1305
GCAAAT,3.5362536642793,0.4793860949595779,1.45287532192601,1.0575156274432098,6,99774,99518,99497,-256,-21,1306
TGGGCC,4.162024664122,0.462704477819681,1.4700104896627801,1.0575094896679,6,96769,99463,99498,2694,35,1307
AATTTA,3.4539169728718995,0.504737236268137,1.4315801110332098,1.0570882744675,6,100000,99592,99499,-408,-93,1308
TAAGAA,3.50058019682797,0.206303756479899,1.4414701323503603,1.0570429862698,6,99886,99552,99500,-334,-52,1309
AGGATG,3.8544251583229303,0.474990902468729,1.45410597110512,1.05704145628979,6,98759,99514,99501,755,-13,1310
ATTAGA,3.10764828090334,0.15130844813361,1.45354533531654,1.05695082360292,6,100806,99515,99502,-1291,-13,1311
TACTTT,3.50016181775863,0.580394523134887,1.4405949462444299,1.0565103752109302,6,99888,99555,99503,-333,-52,1312
TTCTTA,3.4993027638922203,0.608457215811232,1.43973589237802,1.0558608313838198,6,99890,99559,99504,-331,-55,1313
TCTAAT,3.1040127385775094,0.15392743693515099,1.45147138021472,1.0553642317548,6,100815,99522,99505,-1293,-17,1314
TCCAAA,3.80305896914443,0.419227446540258,1.44044334260821,1.05448752502933,6,98982,99558,99506,576,-52,1315
CCCTCA,4.08513374039876,0.647117660803339,1.45571768297713,1.0544860788830501,6,97374,99510,99507,2136,-3,1316
TAACTT,3.1775429015260297,0.498821672331435,1.4477621457620702,1.0543781349708399,6,100684,99533,99508,-1151,-25,1317
GTTGCC,3.76214457791844,0.7134809574031259,1.4662220544163103,1.05432114702432,6,99130,99478,99509,348,31,1318
GGCCCA,4.15937884531034,0.45182612211935996,1.46511834071612,1.0538061534063299,6,96791,99480,99510,2689,30,1319
TCCCTA,3.45866636189269,0.42492143373633706,1.46271826247354,1.0536235964826,6,99983,99488,99511,-495,23,1320
GGTTTC,3.84581753916182,0.504472513204922,1.44949978891969,1.0535575097239498,6,98799,99527,99512,728,-15,1321
TGATGA,3.5671070663860696,0.610252748121754,1.44618454394519,1.05346851334322,6,99693,99538,99513,-155,-25,1322
TCATCA,3.56769658364744,0.59898601084571,1.44608931829556,1.05331062253363,6,99691,99539,99514,-152,-25,1323
GAGCAT,3.4207336278394505,0.310644383932859,1.4629657396000502,1.05290693546076,6,100088,99486,99515,-602,29,1324
ACATAA,3.3273971900957595,0.43463808825808703,1.44116142357658,1.05288085770115,6,100312,99553,99516,-759,-37,1325
ATATAA,3.3660441772627205,0.5860529818486379,1.4282606658531298,1.05271327194071,6,100216,99608,99517,-608,-91,1326
TATCTG,3.41129832341264,0.38119443679316206,1.45000749990466,1.05261753310079,6,100113,99524,99518,-589,-6,1327
TAGGGA,3.45792006604764,0.10102513723803601,1.46073430242841,1.0522782124952499,6,99988,99495,99519,-493,24,1328
GTGATA,3.0617420068522296,0.326205633605893,1.46064789419009,1.05184976659801,6,100900,99499,99520,-1401,21,1329
GAATTC,3.3761567746241496,0.377202873535994,1.45014739748202,1.0518284952294001,6,100195,99523,99521,-672,-2,1330
GCCCAT,3.6520827214899,0.5272536658909871,1.4663059992645902,1.05148342036237,6,99490,99477,99522,-13,45,1331
TTCAGA,3.80140252565939,0.45179462114500896,1.43561021094549,1.0510179987476,6,98990,99577,99523,587,-54,1332
GAATAT,3.25270228570623,0.47859071929478997,1.44052922841054,1.05082737114446,6,100478,99556,99524,-922,-32,1333
TTCCTA,3.56720310443096,0.748683874818978,1.44246786272024,1.05072030381635,6,99692,99548,99525,-144,-23,1334
CCAAAA,3.9527657499291498,0.275763028905676,1.43056713627887,1.05050536766661,6,98223,99598,99526,1375,-72,1335
TTATGT,3.3240832032081604,0.428855855637829,1.43769342376957,1.05049318334179,6,100324,99569,99527,-755,-42,1336
TGGATA,3.4097865006011,0.469470592118888,1.44693408986912,1.0503438497909001,6,100120,99535,99528,-585,-7,1337
GGCAAC,3.7601141133564706,0.7089211401201201,1.460808094709,1.0502510788033002,6,99137,99494,99529,357,35,1338
CACTTT,3.9581127375904197,0.6028140929701321,1.4294799590871399,1.0499889496189498,6,98184,99604,99530,1420,-74,1339
TGCTCT,4.00101691314492,0.601706602218998,1.43901555605481,1.0494643144359,6,97938,99564,99531,1626,-33,1340
TATGTG,3.5958988219138504,0.5480957709186229,1.4396948531071299,1.04946016828752,6,99627,99560,99532,-67,-28,1341
ACCCCT,3.72756351361436,0.390206242292551,1.4606909963633201,1.0493029694101,6,99257,99497,99533,240,36,1342
CACATA,3.60024758985313,0.684558009666736,1.4395509607763999,1.04923821570626,6,99622,99561,99534,-61,-27,1343
ATGGGC,3.64807816433058,0.17103961069026097,1.4626253651291998,1.04885352980281,6,99507,99489,99535,-18,46,1344
AAGTCA,3.6336552044470696,0.643430818883571,1.4378847306819498,1.04883774880796,6,99541,99568,99536,27,-32,1345
GGATGT,3.44304614626644,0.32044238941672804,1.4561970109334201,1.04870403904698,6,100029,99509,99537,-520,28,1346
AGCACT,4.00345556884876,0.7782027075181029,1.43804958770655,1.04870062667762,6,97923,99567,99538,1644,-29,1347
AAGATA,3.3303158365345604,0.594069074077723,1.43520452976342,1.0486447815214002,6,100306,99580,99539,-726,-41,1348
TATCAC,3.0572785466222503,0.31722909735567795,1.4562849331498602,1.04848699735112,6,100906,99508,99540,-1398,32,1349
CCACTA,3.29181583309245,0.342725335372993,1.4612517984101498,1.04832908531645,6,100394,99492,99541,-902,49,1350
AAAGTA,3.48895594355873,0.679291426707893,1.4298458790811102,1.04826229774071,6,99913,99602,99542,-311,-60,1351
TAGAGG,3.4520706876381295,0.0606647056835925,1.4548849240189,1.04791904420096,6,100002,99513,99543,-489,30,1352
GAAGGT,3.4915860106279397,0.6351647596698199,1.45302512147998,1.0475515741683499,6,99903,99516,99544,-387,28,1353
AGTGCT,3.9995683056764704,0.7889166718632179,1.4364086546692698,1.0475230092885202,6,97945,99574,99545,1629,-29,1354
TGTTGT,3.6306286714897102,0.6160708466753461,1.43548942690593,1.04724391688903,6,99545,99578,99546,33,-32,1355
ATGGTA,3.3268879142816,0.657560086276256,1.4451000577328201,1.04705334478553,6,100315,99544,99547,-771,3,1356
GTGCTA,3.18089608945975,0.531501339582047,1.46272481997123,1.04673647305271,6,100678,99487,99548,-1191,61,1357
GGAGAT,3.76183443814668,0.458798456618853,1.4425798051120702,1.04649328263528,6,99131,99547,99549,416,2,1358
GGGAAT,3.6030316035979197,0.41254030106488704,1.44777572826979,1.04647031715346,6,99612,99532,99550,-80,18,1359
TCTGAA,3.79004619035658,0.461740947585216,1.4296768939553701,1.04642184648333,6,99041,99603,99551,562,-52,1360
GTTTGA,3.4411575768577896,0.43744496297588104,1.43936989034875,1.0456457301703,6,100033,99562,99552,-471,-10,1361
GATAAA,3.32610499565198,0.337971857409284,1.4309936888808399,1.0454734367517802,6,100317,99595,99553,-722,-42,1362
TAGTGG,3.28584578208895,0.0326083382553612,1.4570667584648302,1.04540587921778,6,100409,99506,99554,-903,48,1363
CAGTTA,3.24185335553759,0.190934620656,1.44516135466571,1.04501328820453,6,100506,99543,99555,-963,12,1364
CACTCT,3.99697989853479,0.5954232574738629,1.4327322113096699,1.04468246135987,6,97956,99587,99556,1631,-31,1365
TAGCAC,3.18154141673872,0.167254518342951,1.4599655231981101,1.0446595689648899,6,100676,99501,99557,-1175,56,1366
TTGTGC,3.4811725686481805,0.39226738047132204,1.4491879582658798,1.0445986529764,6,99929,99528,99558,-401,30,1367
ATGCTT,3.5198830834563797,0.435060756958196,1.43488964014942,1.04416211007086,6,99826,99583,99559,-243,-24,1368
AAAGTG,3.94750141150553,0.591709018496838,1.4215717701738302,1.04393621307588,6,98259,99630,99560,1371,-70,1369
TGTGTA,3.58850182461957,0.66359637620959,1.43229785581285,1.04389970198515,6,99640,99589,99561,-51,-28,1370
TCTAGG,3.44435259253341,0.0889183345837967,1.44872841613818,1.0433030279637199,6,100026,99529,99562,-497,33,1371
GGAGCC,4.11421108256306,0.467768359978878,1.4515497084721003,1.0429793452487,6,97155,99521,99563,2366,42,1372
CATCCC,3.9105797560909905,0.407768920945557,1.4455657496827599,1.04293552075603,6,98497,99541,99564,1044,23,1373
AATAAC,3.1608604869595998,0.601675027195673,1.43269483214931,1.0429059002348102,6,100710,99588,99565,-1122,-23,1374
GAACCA,3.51738329041793,0.23671172101757396,1.4457621827324398,1.04277497224335,6,99835,99540,99566,-295,26,1375
TTTATC,3.32230769595204,0.45226778042470894,1.42714287545123,1.04269503070052,6,100328,99614,99567,-714,-47,1376
ATCCAG,3.7569453118971197,0.329115710588763,1.4373667558385899,1.0424921676428,6,99148,99570,99568,422,-2,1377
CCTAGA,3.4444087766512297,0.0825435851441227,1.44689909000808,1.04187198722576,6,100025,99536,99569,-489,33,1378
GGCTCC,4.11122526066326,0.465046619075885,1.4497221804893898,1.0415981743946,6,97179,99526,99570,2347,44,1379
CACCAG,4.06899661608079,0.332381585574961,1.4384222647420701,1.0415676085244,6,97471,99566,99571,2095,5,1380
AGGGGT,3.71624982174786,0.596218222872876,1.45000402163791,1.0415649762416999,6,99287,99525,99572,238,47,1381
CCAAAT,3.7063812871919306,0.451701807759553,1.42519103472599,1.04116617919313,6,99330,99617,99573,287,-44,1382
CTTTGA,3.7556274315290694,0.6570379963785661,1.42259254123553,1.04052846832418,6,99154,99624,99574,470,-50,1383
CCTTTT,3.9422124645573198,0.26649600266558,1.4167836489996999,1.04037326765166,6,98283,99648,99575,1365,-73,1384
TTTTGG,3.94153649376518,0.26614395489736603,1.41643160123148,1.0401958393146702,6,98288,99649,99576,1361,-73,1385
ATGCTC,3.4016966622447207,0.29383641772707697,1.4454903612293202,1.03986818371301,6,100138,99542,99577,-596,35,1386
CTGGTG,4.0627789524591,0.33147800540503003,1.43593314819639,1.03984283385225,6,97513,99575,99578,2062,3,1387
GATTAC,3.43474679553166,1.0404142791495,1.43149802098836,1.039667611394,6,100053,99593,99579,-460,-14,1388
GTCACC,3.74470037671305,0.6638372382572281,1.4465315230759201,1.03961272786894,6,99201,99537,99580,336,43,1389
CCTCTA,3.43821774285623,0.320434767404057,1.44226964343708,1.03839342884565,6,100044,99549,99581,-495,32,1390
AGCAAA,3.9422445043896497,0.64933588414933,1.41406853292295,1.0382100315318399,6,98282,99659,99582,1377,-77,1391
GTTGGA,3.50708523739526,0.5910042462642839,1.43917154787904,1.0380004021773,6,99865,99563,99583,-302,20,1392
AAAGGC,3.7927458940078105,0.306237414374015,1.4299708868775902,1.03795717449584,6,99023,99601,99584,578,-17,1393
TCCATG,3.8576669327542206,0.6107819867951589,1.42731020225716,1.0375939247764698,6,98742,99613,99585,871,-28,1394
GAGCTA,3.2473789567143303,0.479539387854921,1.44768118018383,1.03758784790081,6,100493,99534,99586,-959,52,1395
TAAACA,3.50457602219104,0.298605422930443,1.41386682721016,1.03684007595835,6,99869,99660,99587,-209,-73,1396
CATGGA,3.85815706898561,0.58375553004173,1.42623875126454,1.03681895415632,6,98741,99615,99588,874,-27,1397
CAGGAT,3.7795688232929097,0.358097250587353,1.4287150597550402,1.03679662031213,6,99073,99606,99589,533,-17,1398
GAGCCG,3.22975507420893,1.2619856837541699,1.47576823489214,1.03669829644689,6,100547,99443,99590,-1104,147,1399
CATAAA,3.5041760160317703,0.314633780984471,1.4134668210508898,1.03653769010957,6,99870,99661,99591,-209,-70,1400
TGGTTC,3.5035815441555296,0.220447136276698,1.4372294418633202,1.03652194836584,6,99873,99571,99592,-302,21,1401
TGTTTA,3.50318228151152,0.48626144094691,1.4131043157119798,1.03646310220224,6,99878,99664,99593,-214,-71,1402
ATCCTG,3.7772169823007404,0.197180558600552,1.4282856258739498,1.0364373324788299,6,99083,99607,99594,524,-13,1403
AGGCTA,3.40418172434336,0.369550587868421,1.44048519010638,1.0363208982265,6,100132,99557,99595,-575,38,1404
TAGACA,3.3933436785455,0.24570715857735898,1.42824493767851,1.03628491835278,6,100153,99609,99596,-544,-13,1405
ATCTTC,3.51311483916822,0.352832855678002,1.42426499823669,1.03622566163226,6,99846,99621,99597,-225,-24,1406
TAGTGA,3.15464361605565,0.0805141917694598,1.43531405265004,1.0358562708925199,6,100721,99579,99598,-1142,19,1407
GCAAGT,3.46758125443115,0.6347961892287529,1.4372117450025201,1.03551363558659,6,99964,99572,99599,-392,27,1408
CCCAAC,3.7407548128919603,0.42783265262381504,1.4411248712205702,1.03551300646398,6,99214,99554,99600,340,46,1409
GCACAA,3.46869077773044,0.478906163518108,1.4368601802675398,1.03517286348878,6,99961,99573,99601,-388,28,1410
ACAAGG,3.65951040314606,0.40329909487025395,1.43019181859444,1.03498900338688,6,99471,99599,99602,128,3,1411
TGTCCC,3.8973950550003797,0.39683054998995,1.43462737872715,1.03483860705421,6,98554,99584,99603,1030,19,1412
GTGACT,3.4723940555423396,0.417259359153242,1.43499146031146,1.0340918436920699,6,99949,99582,99604,-367,22,1413
GTTATT,3.1487145028285597,0.211815733165034,1.42039483509886,1.03389849204853,6,100735,99635,99605,-1100,-30,1414
TACCAT,3.30954492491184,0.47598735694575606,1.4274331453391298,1.03374098675395,6,100354,99612,99606,-742,-6,1415
CGGCTC,3.22406445261558,-0.137236523807674,1.47155983023981,1.03358680219283,6,100564,99461,99607,-1103,146,1416
CCCGAG,3.22546244237216,-0.283988173132602,1.47147560305538,1.0334955468934202,6,100561,99462,99608,-1099,146,1417
TCACTA,3.1524418099164104,0.530275424172324,1.43202421029288,1.03332204667889,6,100730,99590,99609,-1140,19,1418
TGTAGA,3.38670778804133,0.27056141681874,1.42385537730935,1.03305479813474,6,100168,99622,99610,-546,-12,1419
TTTGCT,3.93337317217911,0.645523230103041,1.40698672381083,1.03303616274949,6,98348,99690,99611,1342,-79,1420
TAGCTC,3.2396610032573903,0.22980860203348602,1.44152481395089,1.0329910688678101,6,100515,99551,99612,-964,61,1421
ATGGGT,3.42184344241168,0.256623820077278,1.43499430707866,1.03291732149193,6,100086,99581,99613,-505,32,1422
AGGTTT,3.58311385839041,0.0559947568312502,1.4173274141748797,1.03286673202122,6,99653,99646,99614,-7,-32,1423
TCAAAC,3.42221394161982,0.577680912262718,1.42214185525419,1.0324736711409102,6,100084,99626,99615,-458,-11,1424
TTCAGC,3.8173633564939,0.31934751104085995,1.42137411790675,1.03235128406348,6,98921,99631,99616,710,-15,1425
TTATAT,3.3405313738718903,0.558925077504146,1.4011327615086397,1.03228788861041,6,100287,99710,99617,-577,-93,1426
TGGCAA,3.8130997328143597,0.46427332719292,1.4209719253158901,1.031952755304,6,98946,99632,99618,686,-14,1427
ACCCAT,3.4225092438822204,0.337620155009839,1.4338750974910102,1.03190529065519,6,100081,99586,99619,-495,33,1428
GCCTTT,3.78484050957587,0.29431513315027,1.4216086954090699,1.03182748615303,6,99053,99629,99620,576,-9,1429
GTTCAG,3.46873650608423,0.351177467236674,1.43173720416027,1.03165832764326,6,99960,99591,99621,-369,30,1430
GGTGAC,3.7327545081958697,0.746768925649524,1.4356948196834098,1.0316396776494001,6,99236,99576,99622,340,46,1431
GGGACA,3.89638413143925,0.394897033626025,1.4301324608309298,1.03155833790239,6,98557,99600,99623,1043,23,1432
CTCGGG,3.2211094892361403,-0.28479350247799606,1.46860486686037,1.03149293493892,6,100576,99468,99624,-1108,156,1433
ATATGA,3.22652361595833,0.572142874658146,1.41435055866264,1.03114242568196,6,100558,99658,99625,-900,-33,1434
GTAATC,3.41885652803558,1.05189468577485,1.4202455297042098,1.0311293394393601,6,100095,99636,99626,-459,-10,1435
CTGAAC,3.46979120008196,0.396432741180687,1.4309275168168203,1.03098649774668,6,99957,99596,99627,-361,31,1436
TTTAAG,3.46735673773004,0.18309418425898605,1.4066315722987601,1.03088336550148,6,99965,99692,99628,-273,-64,1437
GTTTGC,3.4627541022852797,0.46839903856917103,1.43076949190297,1.03087775279549,6,99975,99597,99629,-378,32,1438
TTTATG,3.49571064801446,0.309110880112543,1.4056326822149199,1.0308209892899,6,99895,99696,99630,-199,-66,1439
TGAGGG,4.05108414700344,0.6166045859937751,1.42308004882365,1.03025314903807,6,97592,99623,99631,2031,8,1440
ACAACA,3.61010279693842,0.595131474888275,1.4128712351390502,1.02995749830989,6,99598,99666,99632,68,-34,1441
GTTAAA,3.1417592824097205,0.176026174025385,1.4150547156336901,1.02973884145354,6,100749,99656,99633,-1093,-23,1442
TCCTTA,3.35097999596132,0.441129728215195,1.42020026673869,1.02952905469689,6,100265,99637,99634,-628,-3,1443
CTTAAA,3.4617906126320896,0.17274520909661098,1.40383884207156,1.02861333943701,6,99976,99701,99635,-275,-66,1444
TTGCCA,3.8121187995212797,0.457329909065411,1.41612956093413,1.02842111086408,6,98952,99651,99636,699,-15,1445
GCTTGA,3.62223749206897,0.634353845169171,1.4218461416915602,1.02819009692363,6,99570,99627,99637,57,10,1446
AGTGGA,3.8159389671820403,0.5731365587414251,1.4156197799642398,1.028182351146,6,98928,99652,99638,724,-14,1447
AACCTC,3.8104562178743,0.29359476952888697,1.41542964556191,1.0277662454802499,6,98958,99653,99639,695,-14,1448
TAAGGA,3.35117349364745,0.137996343382552,1.41767388328373,1.02768828026376,6,100264,99645,99640,-619,-5,1449
TCTACA,3.37974178096882,0.26554750924487,1.41620462732584,1.02724148618664,6,100187,99650,99641,-537,-9,1450
GTTGGG,3.72497190014503,0.422067287823724,1.4293732996668203,1.0270222563573,6,99264,99605,99642,341,37,1451
CAGATA,3.38050549362464,0.33607817202903,1.41540675275766,1.02667310731683,6,100185,99654,99643,-531,-11,1452
TACACA,3.5701701346158496,0.24873984749265302,1.40947350553912,1.02663990706489,6,99679,99681,99644,2,-37,1453
TGACTT,3.60448093028727,0.613853469185191,1.4078805976692301,1.02641241102962,6,99610,99687,99645,77,-42,1454
TCTAGC,3.22951910283309,0.10674697345944802,1.43138291352659,1.02546977971407,6,100548,99594,99646,-954,52,1455
GGCCCT,4.08944398644409,0.628046994690774,1.42794090627022,1.0254135469016101,6,97349,99611,99647,2262,36,1456
TAACTG,3.21461466227857,0.17177593186651002,1.4187079035074401,1.0252414818481,6,100602,99642,99648,-960,6,1457
CATTCT,3.9249422966713303,0.5650308416012579,1.3963095181680398,1.02491529890836,6,98410,99726,99649,1316,-77,1458
GACACA,3.8444175277193797,0.522987240596182,1.4102528798633,1.02477708060645,6,98805,99676,99650,871,-26,1459
AGCTCC,4.01471363878389,0.432221150452016,1.4168967118655198,1.02476830482027,6,97847,99647,99651,1800,4,1460
TCATCC,3.5728552623065,0.48151355486701397,1.41883705117845,1.02474245697042,6,99674,99641,99652,-33,11,1461
GTTTGG,3.6445552382122006,0.43687471049229704,1.41508264074117,1.023933981681,6,99519,99655,99653,136,-2,1462
GCATCT,3.53926505555744,0.38977661230574295,1.4186567035286497,1.02386557593391,6,99764,99643,99654,-121,11,1463
AAACCT,3.5698326815397103,0.0412539662890818,1.40535854416069,1.02363485888493,6,99683,99698,99655,15,-43,1464
GCCATC,3.6931040979268803,0.46710234976257303,1.4259020016313002,1.0235217876049598,6,99372,99616,99656,244,40,1465
CAGTCC,3.72287965870027,0.22805499786924202,1.4247108050631299,1.02339695503911,6,99269,99619,99657,350,38,1466
TTGAAT,3.4513799152690097,0.65399636615825,1.39658339583531,1.02317380825535,6,100007,99725,99658,-282,-67,1467
GAAACT,3.73097033093474,0.445792310667162,1.3995505415948604,1.02302433433228,6,99248,99717,99659,469,-58,1468
ATGATG,3.5265091081606297,0.5934290770610511,1.40558658571975,1.0229818900183298,6,99804,99697,99660,-107,-37,1469
GGTAGA,3.4177382764148097,0.48971903999046507,1.42055251279558,1.02236249355193,6,100098,99634,99661,-464,27,1470
GCAAAC,3.4514549149912996,0.5853083723245001,1.41962431752841,1.0223410059184201,6,100005,99639,99662,-366,23,1471
TGTGTC,3.83498896193964,0.638177081974323,1.40687856157759,1.02233225401971,6,98841,99691,99663,850,-28,1472
CAATGT,3.36385018919531,0.400250508482801,1.40908807661454,1.02176356438246,6,100220,99683,99664,-537,-19,1473
AGCCCT,4.01042626257572,0.6211581818619399,1.4126093356573501,1.02156666284938,6,97874,99667,99665,1793,-2,1474
AGGGCC,4.08511558201948,0.6242580126515699,1.42245420792852,1.0213615240207499,6,97375,99625,99666,2250,41,1475
ATCAGA,3.52583872679741,0.41885428442104494,1.40266987422153,1.02073687135173,6,99808,99703,99667,-105,-36,1476
GGATGA,3.5684954497044,0.47347932712308505,1.4132395743762698,1.0206931989388002,6,99688,99662,99668,-26,6,1477
CCCTTT,3.9616609549980804,0.37120899560974,1.40061723071863,1.0205339944684801,6,98166,99713,99669,1547,-44,1478
GATGGC,3.68820562322298,0.46498967171543504,1.4216882698384,1.0204836422327501,6,99392,99628,99670,236,42,1479
TAGCCT,3.38171803226004,-0.0671737593807542,1.4191797919401499,1.02045616966522,6,100181,99640,99671,-541,31,1480
AAGTTA,3.12935986750468,0.460410273252865,1.4026553007286497,1.02043603808438,6,100776,99704,99672,-1072,-32,1481
TCCACA,3.8369979694503997,0.517678658311462,1.40439490881833,1.02035851717177,6,98835,99699,99673,864,-26,1482
GATATA,2.9055699973991,0.127977924734827,1.4095371635211997,1.02029977174896,6,101108,99680,99674,-1428,-6,1483
AAACTT,3.51965516519449,0.230609761659011,1.3907959365373002,1.02029761872835,6,99827,99735,99675,-92,-60,1484
TGACTC,3.48248309512092,0.30440200506461895,1.4146699047944498,1.0196364996062,6,99926,99657,99676,-269,19,1485
TATATC,2.90314403688513,0.41308229755001397,1.4086727902312401,1.0196249979821301,6,101113,99685,99677,-1428,-8,1486
GGAGCT,4.00722492830539,0.425950575917721,1.4097319244109399,1.01951403407885,6,97897,99678,99678,1781,0,1487
ATCTCC,3.72496831561414,0.301350954430818,1.40654805347269,1.01941075847104,6,99265,99693,99679,428,-14,1488
CAAAGC,3.79825511631875,0.693999039407194,1.40388097868527,1.01909510036376,6,98999,99700,99680,701,-20,1489
TCTGAT,3.51957482883563,0.4322779472485971,1.40021389361875,1.0189224991451,6,99828,99714,99681,-114,-33,1490
GATAGA,3.1805540543250497,0.47360997756121204,1.4110532016678101,1.01889972279429,6,100680,99674,99682,-1006,8,1491
GGACTA,3.2511913898489904,0.564154967965264,1.4209512781906102,1.0185250996805602,6,100483,99633,99683,-850,50,1492
TTTGTG,3.94354666013715,0.5862059143855911,1.38664911748353,1.01836648894999,6,98276,99747,99684,1471,-63,1493
GTCAGT,3.31974091294076,0.440321760115056,1.41798763328464,1.0181442048606,6,100331,99644,99685,-687,41,1494
GCTGAA,3.7946104210187297,0.306548423452075,1.4024826135202602,1.01810434818202,6,99016,99706,99686,690,-20,1495
CCACCG,3.26588894100006,1.2889361655067402,1.44789202540385,1.01799361788137,6,100449,99531,99687,-918,156,1496
AGCCAA,3.95769423801796,0.605656166979689,1.3971073207750901,1.01776913272379,6,98186,99723,99688,1537,-35,1497
TCTAGT,3.10083102061387,0.20411717726541,1.4120125514936,1.01776786260488,6,100824,99670,99689,-1154,19,1498
AATCAC,3.40251008695157,0.381265228314257,1.40243800058595,1.01771852547679,6,100136,99707,99690,-429,-17,1499
AGGGCT,4.0046700552399095,0.619727213720196,1.4071770513454598,1.01760625541583,6,97915,99689,99691,1774,2,1500
GCAAGG,3.8382853829085,0.5467799031049411,1.4118242225227702,1.01696711728272,6,98826,99672,99692,846,20,1501
AAAATC,3.6741991103149902,0.22676681050142702,1.3815709178746203,1.01673204873188,6,99429,99762,99693,333,-69,1502
ACATTG,3.35628891229837,0.394796393106025,1.4023120418183401,1.0166759542821602,6,100246,99708,99694,-538,-14,1503
CATCAT,3.51855843383681,0.572128714670823,1.3969511684849298,1.01641932323138,6,99832,99724,99695,-108,-29,1504
GAGTCA,3.47983307452183,0.298085677696127,1.4096730548706102,1.01596376264008,6,99933,99679,99696,-254,17,1505
AGATTT,3.60076132335465,0.21223629122419196,1.38196604621447,1.01563523857003,6,99621,99760,99697,139,-63,1506
ACTCTA,3.09695043858913,0.359273211013623,1.40929026338595,1.0155997219525001,6,100830,99682,99698,-1148,16,1507
GAGGTT,3.79659010834666,0.27870146162618603,1.39871077088053,1.01551828146065,6,99007,99718,99699,711,-19,1508
GTGCAA,3.44045088439213,0.414498811289485,1.4100813749634902,1.0153180489870999,6,100038,99677,99700,-361,23,1509
TGTCAT,3.5144969947656204,0.570313605734643,1.3951360595487499,1.01511315434589,6,99840,99729,99701,-111,-28,1510
CCTTGC,3.8373295790829105,0.547950619741252,1.40892939471959,1.01487401966287,6,98833,99684,99702,851,18,1511
TCAGTA,3.33192505622518,0.502822464908517,1.39998703308546,1.01443168946596,6,100299,99716,99703,-583,-13,1512
GTGATT,3.3993726206211,0.379852832953828,1.3975849341120499,1.0143413813192,6,100142,99721,99704,-421,-17,1513
AGATGC,3.52758471714477,0.37980779366615103,1.40581807119889,1.0143180009005202,6,99802,99695,99705,-107,10,1514
ACTGAC,3.3153680592489905,0.3655402678232849,1.41293893365936,1.01429656609228,6,100341,99665,99706,-676,41,1515
TCAGAC,3.44650228753448,0.494838812340182,1.4080418975762599,1.01394203841874,6,100018,99686,99707,-332,21,1516
CTGTAC,3.2830041883765397,0.33165736728884304,1.41254724510651,1.01328805343714,6,100414,99668,99708,-746,40,1517
GACAGC,3.6806493811071097,0.30985909072162504,1.4118856975875198,1.0131493091012902,6,99411,99671,99709,260,38,1518
ATGACA,3.5157141846677598,0.580387823433178,1.39254533209188,1.01314290630543,6,99838,99731,99710,-107,-21,1519
GTACAG,3.2837193168722796,0.311736874070156,1.4121040796851598,1.01298075552187,6,100412,99669,99711,-743,42,1520
ATAAAC,3.27410705284167,0.5535553411185731,1.3878712863224798,1.01278136303196,6,100432,99744,99712,-688,-32,1521
TTGGCT,3.9508669716674,0.5094905405686371,1.3901471704118702,1.01276392199258,6,98233,99738,99713,1505,-25,1522
AATGGA,3.74598902307078,0.5415749182227589,1.3840581394455702,1.01207311280336,6,99196,99752,99714,556,-38,1523
CGGTGG,3.2562050214293303,-0.418097393788498,1.4388559518809598,1.0116241988539099,6,100468,99565,99715,-903,150,1524
TAGTCC,3.24034488086995,0.477608672318379,1.4112419342218998,1.0113074792574799,6,100511,99673,99716,-838,43,1525
GAGATT,3.5584997814846098,0.247075021727698,1.38830535498046,1.01111566863315,6,99718,99743,99717,25,-26,1526
GGACTG,3.70435032336967,0.21144355673311901,1.4072906348572098,1.01054187844772,6,99337,99688,99718,351,30,1527
CCTTTG,3.9771097859407503,0.6531211427162571,1.38555496737596,1.00994969575622,6,98071,99750,99719,1679,-31,1528
ATCTGA,3.47911914641765,0.448678316459832,1.3887077182621201,1.00958814019283,6,99935,99741,99720,-194,-21,1529
ACATCC,3.39214003749676,0.27766795543307204,1.40350589110556,1.00932294866738,6,100158,99702,99721,-456,19,1530
ACCCAA,3.6252076257478194,0.37211183571207107,1.39556511817228,1.00903461643769,6,99560,99727,99722,167,-5,1531
CCAGTC,3.8341826961867795,0.29472714111470005,1.4007678202818101,1.0088602991608,6,98845,99711,99723,866,12,1532
CCAAAC,3.62456305041274,0.560604597633283,1.3949205428371998,1.00855443922134,6,99563,99730,99724,167,-6,1533
ACATAG,3.3168144445288394,0.38566703909857797,1.39219037441707,1.00837792135446,6,100338,99732,99725,-606,-7,1534
CCTAGC,3.4409348956816297,0.17313776332178302,1.4132282851652198,1.00817802998429,6,100036,99663,99726,-373,63,1535
TCAGAT,3.4768176494293703,0.48964494640381107,1.38680951458075,1.00815649667532,6,99940,99746,99727,-194,-19,1536
TAACAC,3.0817533218642597,0.27741607912752797,1.3985657319162301,1.00745293498286,6,100857,99719,99728,-1138,9,1537
CTCTCA,3.94738363854909,0.545826997488161,1.38313595132397,1.00742568955399,6,98261,99755,99729,1494,-26,1538
TCCATT,3.7414251698221,0.560666226870209,1.37719444233221,1.00696929975104,6,99211,99771,99730,560,-41,1539
ATCTTT,3.5881464084608,0.277565005519859,1.3705094252377001,1.0069584468708799,6,99642,99783,99731,141,-52,1540
TGAAGT,3.57526593677435,0.681682044017432,1.3817417931442402,1.00670608324399,6,99670,99761,99732,91,-29,1541
GCTAGG,3.43836040166403,0.180178266645656,1.41097771417155,1.00662038606398,6,100042,99675,99733,-367,58,1542
AGTAAA,3.4335731481470697,0.366722813931942,1.3744630836694598,1.00648121753828,6,100055,99774,99734,-281,-40,1543
GACTGG,3.83087022471043,0.29292083573109695,1.3973759785224598,1.00644383651867,6,98860,99722,99735,862,13,1544
CAGTCA,3.65621339810724,0.284019871913964,1.39045549024627,1.0061647813432901,6,99480,99737,99736,257,-1,1545
GATTTT,3.6642861952759502,0.216578567370121,1.36686621370424,1.00590711631181,6,99461,99795,99737,334,-58,1546
TTGGGT,3.6200693679720404,0.45484974563763997,1.39059677050101,1.00565183618356,6,99575,99736,99738,161,2,1547
TAATGC,3.07984175141765,0.318458400415386,1.3955418819576002,1.0053404363561,6,100866,99728,99739,-1138,11,1548
AAAGAT,3.58567385023031,0.617939221670577,1.3684936740437998,1.0053143829751099,6,99646,99788,99740,142,-48,1549
ACCTTG,3.62147480125223,0.48194806011679403,1.38925955991236,1.00455624596764,6,99572,99739,99741,167,2,1550
CTATGT,3.30895982173437,0.378117565442206,1.3869551335739398,1.00452173623806,6,100357,99745,99742,-612,-3,1551
AAAGGG,3.9395153721705403,0.35642120981499703,1.3792523779516,1.00445910197044,6,98304,99766,99743,1462,-23,1552
CGGGGC,3.26090440678707,-0.139375246317051,1.44355533723871,1.00422042963193,6,100459,99546,99744,-913,198,1553
TGACTG,3.6493375544511495,0.294592592131595,1.3866112188259399,1.00333362977394,6,99500,99748,99745,248,-3,1554
GCCCCG,3.25980305361721,0.8645522670154069,1.441806138021,1.00284148771402,6,100462,99550,99746,-912,196,1555
GAAGCT,3.7524841501510204,0.5648156954084009,1.38267605721856,1.00277523423835,6,99172,99758,99747,586,-11,1556
TGTGAT,3.68675729530117,0.6037817351822921,1.3724832147855601,1.0024416881784102,6,99397,99778,99748,381,-30,1557
AAGTTT,3.49382141839462,0.20955886492356302,1.3664232777716898,1.00197368697166,6,99899,99797,99749,-102,-48,1558
ACAGTC,3.4304097439141805,0.29158214834095897,1.39194935395596,1.0019722552985,6,100066,99733,99750,-333,17,1559
CAAGGT,3.6198523900543904,0.590092496062757,1.38569361269669,1.00193389418147,6,99576,99749,99751,173,2,1560
CTTTTG,3.8914965200251097,0.580433862428849,1.36511007165683,1.00141281081474,6,98584,99800,99752,1216,-48,1561
CAAAGG,3.9654939684679706,0.663749904467679,1.37363184374576,1.00088732891267,6,98142,99776,99753,1634,-23,1562
GTCAGC,3.50108048474772,0.25523530002194394,1.40072354122324,1.00080689254247,6,99883,99712,99754,-171,42,1563
TAGTAT,2.86852213862394,0.5229261634921339,1.3828259330322399,1.0001745060440201,6,101153,99756,99755,-1397,-1,1564
ATTTAA,3.53268985200481,0.3766347440986071,1.3522828784572198,1.00010703728933,6,99788,99844,99756,56,-88,1565
TTTACT,3.4250342273069503,0.355068297745559,1.3654673557927501,0.9998257043611171,6,100074,99798,99757,-276,-41,1566
TTGCAC,3.42256673463642,0.39165468615726895,1.3891210362198503,0.99981060579551,6,100080,99740,99758,-340,18,1567
TTAAAT,3.53155071437146,0.377654513857435,1.35114374082387,0.9992420261525642,6,99792,99848,99759,56,-89,1568
TAGCAA,3.30443122980282,0.241456031760881,1.3791229991584297,0.998631757677481,6,100368,99767,99760,-601,-7,1569
TGAGAG,3.9352131732572504,0.530299832102067,1.37089522833296,0.998333427520352,6,98332,99781,99761,1449,-20,1570
CACATG,3.9961195434849603,0.613610386444488,1.36860333755415,0.997897790321458,6,97961,99787,99762,1826,-25,1571
GTTTAT,3.25364006567191,0.27797841312568,1.36725028623331,0.9975016406855641,6,100476,99794,99763,-682,-31,1572
GTGGAC,3.3370092731032504,0.273163368784632,1.4017078826606297,0.9974620953367941,6,100291,99709,99764,-582,55,1573
CATGTG,3.99300197843189,0.5990306230328261,1.3677321026360902,0.9972973279092849,6,97977,99791,99765,1814,-26,1574
GAACCT,3.42429873221552,0.17301879864210998,1.38543504895039,0.997138993681629,6,100076,99751,99766,-325,15,1575
TGTGAG,3.9620218646132703,0.5996496397174661,1.36835111932073,0.9971221986030259,6,98162,99789,99767,1627,-22,1576
TAGGAG,3.5426072584606803,-0.0414650754017387,1.3814227371349699,0.9971161599938041,6,99758,99763,99768,5,5,1577
AGAATG,3.8848900334722596,0.5239477991134439,1.35896039214057,0.996651810651053,6,98609,99818,99769,1209,-49,1578
CTCACC,4.00716344188876,0.6011637742411539,1.3777473844671202,0.996230332039731,6,97898,99768,99770,1870,2,1579
GGTGAG,4.0054788045553,0.613771516484066,1.3774747063755102,0.9961964466843749,6,97911,99770,99771,1859,1,1580
TAGAGT,3.0726847020948,0.202447981329492,1.38270793905745,0.9959790293378741,6,100881,99757,99772,-1124,15,1581
TAGAAC,3.0356350834294,0.250516156078438,1.3840466239846299,0.995960801178596,6,100945,99753,99773,-1192,20,1582
AATATC,3.25864717308949,0.534077648588719,1.3650974535423501,0.9958828351441601,6,100464,99801,99774,-663,-27,1583
TTCATT,3.84124104818711,0.7607870295656441,1.3482231784056598,0.9957120378720179,6,98817,99856,99775,1039,-81,1584
TATTCA,3.45146172030429,0.530195684113309,1.3591374243697398,0.99569543318912,6,100004,99816,99776,-188,-40,1585
AAATCT,3.5712295312224103,0.18767581895797603,1.35520764895298,0.99526164699488,6,99676,99832,99777,156,-55,1586
CAAAAG,3.88525371363761,0.606523289797687,1.35707774217091,0.9951793833239742,6,98607,99823,99778,1216,-45,1587
GTCTGA,3.41964433526496,0.389203505307144,1.38224174003409,0.994842518269328,6,100092,99759,99779,-333,20,1588
TCATTG,3.4874410338975297,0.543257644866554,1.3680800986806598,0.994831476011668,6,99917,99790,99780,-127,-10,1589
TCTACC,3.3796157035703795,0.45004140463986003,1.38366760415123,0.994818299900523,6,100188,99754,99781,-434,27,1590
TTGCTA,3.30071629204368,0.6888063258704521,1.37379296044561,0.99480144807463,6,100375,99775,99782,-600,7,1591
ATCCAT,3.4103638333542996,0.44670592923262703,1.3701819420726897,0.994543090220643,6,100117,99785,99783,-332,-2,1592
GACAGT,3.45096227559478,0.484304757776249,1.3808022559435502,0.994482494302645,6,100008,99764,99784,-244,20,1593
CTCCTA,3.5378560645262795,0.392830352680225,1.3775059140937298,0.9940839484170921,6,99768,99769,99785,1,16,1594
GTGTTA,3.06263272998571,0.32060494345338797,1.38007636921902,0.9939066276532871,6,100898,99765,99786,-1133,21,1595
GCTGAC,3.49041836959108,0.294912478099157,1.3908466681673401,0.9934880993727121,6,99909,99734,99787,-175,53,1596
ATGGAT,3.40742359706988,0.5800256573556359,1.3675656288121998,0.992676447586218,6,100126,99792,99788,-334,-4,1597
AGCTTC,3.7370566731046004,0.539410415892572,1.3688101673961397,0.9923808043448299,6,99222,99786,99789,564,3,1598
GACCAC,3.49270489525699,0.27014637875818304,1.38867284179533,0.9918746963062529,6,99901,99742,99790,-159,48,1599
ATATCT,3.33085028565539,0.51362908056581,1.3558367645703,0.9907253806166411,6,100303,99830,99791,-473,-39,1600
GATATT,3.2546276067465003,0.479808658938296,1.3579011990216898,0.990648046900202,6,100475,99820,99792,-655,-28,1601
CGCCCC,3.24231055150419,-0.162979505000042,1.42431363590797,0.990114174944525,6,100505,99620,99793,-885,173,1602
AATCTC,3.52570888803176,0.21033544194975898,1.36025273692929,0.9898736300482499,6,99809,99815,99794,6,-21,1603
GTTCTA,3.02722245767458,0.28616466925388595,1.37517719119324,0.9894991241216942,6,100957,99772,99795,-1185,23,1604
CTTGCT,3.9210571967424,0.7115638568462449,1.3590558396523003,0.989417045287386,6,98432,99817,99796,1385,-21,1605
AATGAA,3.82689251455903,0.7551879824683828,1.33935117681992,0.9887687066345909,6,98881,99886,99797,1005,-89,1606
AGCAAG,3.92371531170883,0.6973041564610921,1.35715103664954,0.98797165058916,6,98418,99822,99798,1404,-24,1607
AAAACT,3.7960272085280495,0.18419285770108998,1.3389969650742801,0.9878483054718129,6,99010,99887,99799,877,-88,1608
ACTTCA,3.55513488392335,0.499773863737513,1.3562882211703,0.987628341347006,6,99722,99827,99800,105,-27,1609
GCATTA,3.0563324685740296,0.350472140932032,1.37152977767234,0.9874957734060429,6,100910,99780,99801,-1130,21,1610
CGCGCC,3.04832335250956,0.7576102640215241,1.4281383470259899,0.9871823333975931,6,100921,99610,99802,-1311,192,1611
GGGGCG,3.2372281538904906,0.7762717584007891,1.41987908434212,0.987134280622523,6,100522,99638,99803,-884,165,1612
CAATGA,3.48099098560425,0.545664624369669,1.3578221330283702,0.987120354288913,6,99930,99821,99804,-109,-17,1613
ACTCAA,3.36101458254642,0.350837213247111,1.3609424961807999,0.9866833896349559,6,100232,99811,99805,-421,-6,1614
GAACTA,3.02087573577794,0.450881957455037,1.37044557025027,0.9858290962713729,6,100962,99784,99806,-1178,22,1615
GCTGTC,3.63960022516035,0.278710268931585,1.37464445899977,0.985567830156728,6,99532,99773,99807,241,34,1616
AACCAC,3.59342680301726,0.24525783240457102,1.3637842954417199,0.985334205907403,6,99632,99804,99808,172,4,1617
GGCGCG,3.04488018275719,1.2722741922902399,1.4250191002975499,0.9850616471785291,6,100929,99618,99809,-1311,191,1618
TTGGAA,3.8668677277001695,0.6290895775938741,1.34337793612014,0.9849022523296508,6,98693,99874,99810,1181,-64,1619
CCCCCT,4.0334596297331,0.46966751096809706,1.3716326265352903,0.9835479423399579,6,97705,99779,99811,2074,32,1620
CCAAGC,3.7935364329960204,0.496347664809234,1.36675134958637,0.983358169214005,6,99019,99796,99812,777,16,1621
ACTTGT,3.1960377302099103,0.398450461556392,1.36119569566171,0.983315897865318,6,100651,99809,99813,-842,4,1622
GCTCAA,3.5587473804401704,0.499942010146082,1.36153271824044,0.9830267214982371,6,99716,99808,99814,92,6,1623
AGTCAG,3.7253825018107496,0.45881313400825796,1.3559777021851998,0.9828103631313739,6,99263,99828,99815,565,-13,1624
TTGAGC,3.56116171506933,0.371944887451775,1.36077036469192,0.9826387841062629,6,99712,99812,99816,100,4,1625
TTTGAA,3.8198799189910297,0.5419401447942729,1.33072348029826,0.9823602133724301,6,98911,99923,99817,1012,-106,1626
TCAAAG,3.6764830055879503,0.48010634748666803,1.345466509555,0.9823375172829741,6,99421,99866,99818,445,-48,1627
AAGCCC,3.7920168408225696,0.44913972614427605,1.36523175741292,0.982228628027672,6,99029,99799,99819,770,20,1628
GATTTC,3.5178115486785195,0.404151433683611,1.34917870939838,0.9817459700960699,6,99833,99852,99820,19,-32,1629
ACTGTC,3.4310062017694802,0.267098144871131,1.36319301144301,0.981345261406548,6,100064,99805,99821,-259,16,1630
TTCAGG,3.94025727120118,0.276162236357615,1.34678004552531,0.9808875468011999,6,98300,99861,99822,1561,-39,1631
TACTGA,3.287374016561,0.42286140095815794,1.35503270011437,0.980862563063131,6,100405,99834,99823,-571,-11,1632
GTGGTC,3.4742259201010297,0.24499595104557198,1.3735404649215701,0.980846512446482,6,99943,99777,99824,-166,47,1633
GGCCAT,3.7475518205264198,0.576763583031228,1.36428711121238,0.980622919385168,6,99188,99803,99825,615,22,1634
AAGCCT,3.7141879181616098,0.26529612652082,1.35257120494849,0.9800442846577099,6,99294,99842,99826,548,-16,1635
ACAAGT,3.1901755588240803,0.392684665149424,1.35694862522955,0.9800002996495161,6,100658,99824,99827,-834,3,1636
TTGAGT,3.35332920106118,0.511250811227272,1.3515415145521399,0.979906438357291,6,100258,99847,99828,-411,-19,1637
CCCCTT,3.98161610989614,0.52932961916769,1.3554040154201699,0.9795539651289978,6,98045,99831,99829,1786,-2,1638
TAGTTC,3.01489631553495,0.308251989563127,1.3616927551365199,0.979509716500921,6,100972,99807,99830,-1165,23,1639
GATAAT,3.0040065867596204,0.404703548440743,1.3499036411728302,0.979316116344057,6,100988,99850,99831,-1138,-19,1640
TACCCA,3.54974131829027,0.34334152484062297,1.3566337434373799,0.9792346972739141,6,99741,99825,99832,84,7,1641
GTAAAT,3.22777626790514,0.36951236245377705,1.3430015894202099,0.979152395209354,6,100554,99875,99833,-679,-42,1642
AATGGC,3.74213523554567,0.39330882992423,1.3500074280471999,0.97885377442706,6,99208,99849,99834,641,-15,1643
CCAACA,3.93649443817391,0.647883527636818,1.3443083904277802,0.978802800919275,6,98324,99871,99835,1547,-36,1644
GGGCTT,3.78834210675734,0.4510716895556521,1.36026584541794,0.978790140706121,6,99045,99814,99836,769,22,1645
TTCAAG,3.8648349591407998,0.7476077378804101,1.33504388672042,0.978704571460658,6,98707,99908,99837,1201,-71,1646
AAGGGG,3.97798698260481,0.536659026917064,1.3540378351303601,0.9785703964292399,6,98067,99836,99838,1769,2,1647
AACTCC,3.9038799672650097,0.359775782525725,1.3444513439392298,0.97825784571345,6,98524,99869,99839,1345,-30,1648
ATACTA,2.84058490351243,0.613548363274655,1.35342760988648,0.9781757970458991,6,101172,99837,99840,-1335,3,1649
ATTTAC,3.22916513106857,0.36566612923710706,1.34131426359572,0.9779584355196801,6,100549,99880,99841,-669,-39,1650
GTATTA,2.83865693740178,0.382589422377018,1.35296073181009,0.9779016702801429,6,101175,99840,99842,-1335,2,1651
AGGGGG,4.02509209852552,0.47011739048479795,1.3627546474584902,0.97718560403269,6,97772,99806,99843,2034,37,1652
TATCCA,3.31259753017136,0.37768619722726293,1.34906037652838,0.9770515038726271,6,100346,99853,99844,-493,-9,1653
TGGGTA,3.54374140261854,0.345898069081477,1.35320408092458,0.976830059057211,6,99757,99838,99845,81,7,1654
CCCCCG,3.22385683923475,0.8286060526329491,1.4058599236385398,0.9767591972032621,6,100565,99694,99846,-871,152,1655
AATAGT,3.0709635116374505,0.43758158804438596,1.3442589448614197,0.976685558786321,6,100884,99872,99847,-1012,-25,1656
CTGACT,3.71640813430399,0.466898455542221,1.34775833528862,0.976661861507153,6,99285,99857,99848,572,-9,1657
GCCATT,3.7425537569050897,0.387764866449219,1.34656451831794,0.97637429902165,6,99205,99863,99849,658,-14,1658
GCCAAA,3.74089135862112,0.251914334938389,1.34651722098764,0.976192232063234,6,99213,99864,99850,651,-14,1659
TGTTTG,3.8875890384245197,0.598257671111195,1.3306914957708897,0.9761292175568391,6,98598,99924,99851,1326,-73,1660
CCTGAA,3.930308788278,0.270353774328459,1.3403690706668798,0.975903107279343,6,98375,99882,99852,1507,-30,1661
TCTATC,3.11957356072756,0.421218488809776,1.3531958825183201,0.975750007449722,6,100796,99839,99853,-957,14,1662
ACTATG,3.1481855660710605,0.44840677722460703,1.3522788072999299,0.9757336354493791,6,100737,99845,99854,-892,9,1663
GCTTGG,3.78394046888263,0.490757154435981,1.3558642075432399,0.9755210133715359,6,99059,99829,99855,770,26,1664
TAGCTA,3.04397660834229,0.34864680275526694,1.35515813922203,0.9754229529862081,6,100932,99833,99856,-1099,23,1665
TAATAC,2.8368224696196003,0.321040365411859,1.34966517599365,0.975372474724529,6,101176,99851,99857,-1325,6,1666
ATGGCC,3.7396083661169905,0.23481182219017102,1.3563436568029499,0.9747273795009521,6,99217,99826,99858,609,32,1667
GGCGGC,3.21996223374694,-0.199364522389535,1.4026131641985802,0.9745800772889699,6,100581,99705,99859,-876,154,1668
AGGATA,3.27996422553124,0.367349546531118,1.34646461516751,0.974488200364764,6,100420,99865,99860,-555,-5,1669
GTGGTT,3.5779791056289,0.219961994281872,1.3485065081578702,0.974268500684229,6,99664,99855,99861,191,6,1670
GGACTC,3.46675329360884,0.150510399235531,1.3646067503951103,0.9741728787209859,6,99967,99802,99862,-165,60,1671
GAAGAT,3.4315378016067704,0.522107717723991,1.33996807953415,0.9731154505798609,6,100063,99885,99863,-178,-22,1672
ACCAAG,3.5826539653404903,0.368103076307628,1.34703409994853,0.973040316537266,6,99655,99859,99864,204,5,1673
CATAGT,3.14530085622743,0.44259849009610297,1.34860885535555,0.973020076991283,6,100744,99854,99865,-890,11,1674
TGTTGG,3.927325249225,0.637583629145437,1.3360943536841299,0.972929503717689,6,98401,99901,99866,1500,-35,1675
AGGCTT,3.7071660356532097,0.271841325331371,1.34277592756933,0.9728956792243629,6,99321,99876,99867,555,-9,1676
ATTATC,2.99380250106385,0.501483707479022,1.3412611427010601,0.9728294166907421,6,101004,99881,99868,-1123,-13,1677
GCCGCC,3.21807987100638,-0.206183973227967,1.40008295541017,0.9726493223772271,6,100589,99715,99869,-874,154,1678
GCATAT,3.1889512281891603,0.492385312204267,1.34658124702021,0.9725425146877571,6,100662,99862,99870,-800,8,1679
TTCATA,3.41988377314946,0.740123328374896,1.32755947721491,0.971910996580145,6,100090,99937,99871,-153,-66,1680
AAGTCT,3.4990119206533996,0.386434210791894,1.33599887130864,0.971697961834306,6,99891,99902,99872,11,-30,1681
CGGGGG,3.2158384119138597,-0.18223129553946302,1.3984893423654898,0.971664561202639,6,100598,99720,99873,-878,153,1682
AGAGCC,3.94442300157087,0.504852384504513,1.34544778073541,0.9715101643926279,6,98273,99867,99874,1594,7,1683
TACATT,3.4193505997555094,0.568508433660108,1.32702630382096,0.971509243019817,6,100094,99940,99875,-154,-65,1684
ATATGC,3.1869827236164903,0.49274829615670296,1.3446127424475403,0.971076822969428,6,100665,99868,99876,-797,8,1685
GAGTCC,3.46285426342559,0.158475731962129,1.3602832979982,0.9709918533650409,6,99973,99813,99877,-160,64,1686
AGTTTC,3.6624818637824905,0.38482299108109796,1.32985026679587,0.970747595328109,6,99466,99929,99878,463,-51,1687
CTTGGT,3.57454223461128,0.504097478866832,1.3437880813056697,0.970732865932002,6,99671,99873,99879,202,6,1688
AGTTTT,3.7771028098021002,0.16539642418979,1.31568407052391,0.9704694228618309,6,99084,99971,99880,887,-91,1689
ACTATT,3.06559035427397,0.42780962407330997,1.33580959851001,0.9704361835883459,6,100893,99903,99881,-990,-22,1690
CATCAG,3.7383756340238703,0.43784026074971794,1.33737170389506,0.9695621828549449,6,99220,99897,99882,677,-15,1691
GGTCAC,3.4601460015766503,0.336826686091237,1.3579994583629298,0.9692956112012951,6,99980,99819,99883,-161,64,1692
TGAATA,3.41209477950337,0.492612109703865,1.3236319146575,0.9688688532872242,6,100110,99950,99884,-160,-66,1693
AAGGAC,3.57082237353055,0.7320732712704972,1.3415037889789299,0.968829608724922,6,99678,99879,99885,201,6,1694
TATAAC,2.71654575112085,0.36571901197490103,1.34435395645301,0.9688192679156851,6,101241,99870,99886,-1371,16,1695
AATGTA,3.4119268392896895,0.636897670113394,1.3234639744438201,0.9687425344748279,6,100111,99951,99887,-160,-64,1696
GACTGT,3.38446646864582,0.266173995597272,1.34706387341494,0.9687163557078271,6,100174,99858,99888,-316,30,1697
TAACCA,3.1408039271664197,0.193157750429732,1.34265083826028,0.968512719155987,6,100752,99877,99889,-875,12,1698
ATCTGG,3.65616814354241,0.233616661633526,1.3380718044248898,0.9683622682984642,6,99481,99892,99890,411,-2,1699
ACAATG,3.52561875803209,0.5263450796137,1.3306335263677198,0.96831059959986,6,99811,99925,99891,114,-34,1700
GGACCC,3.69289987401226,0.264252405483177,1.36118290958862,0.9678897420767741,6,99375,99810,99892,435,82,1701
TCCAAG,3.73587341721501,0.5183412716242021,1.3348694870862,0.9676925887549491,6,99230,99909,99893,679,-16,1702
CTTGAA,3.8444644399839802,0.7355298982178359,1.31969309256938,0.9670356187708951,6,98804,99962,99894,1158,-68,1703
TGGTTA,3.13465153206007,0.18784421029188197,1.3402058613232,0.966823713043852,6,100766,99884,99895,-882,11,1704
CCATTA,3.21975531967746,0.27554957507625705,1.33764354010475,0.966725745427115,6,100582,99894,99896,-688,2,1705
GGCTCT,3.9352260454051398,0.50158238159197,1.33889133542778,0.9666824351748249,6,98331,99889,99897,1558,8,1706
AAATAG,3.53448483035295,0.34381542720000396,1.31730465416644,0.9666782682023579,6,99781,99966,99898,185,-68,1707
TAATGG,3.21885288512796,0.23222786797668804,1.3370650285791799,0.9663861192782329,6,100585,99898,99899,-687,1,1708
TTTGGC,3.7263328104042297,0.23827597802757003,1.3325899019520902,0.965989688495373,6,99260,99914,99900,654,-14,1709
CTTGAG,3.89091222094918,0.5640493800505451,1.3277525699419799,0.9659782138760981,6,98588,99936,99901,1348,-35,1710
CATTGT,3.5245831865499997,0.507779031600627,1.3271976118312099,0.9658960956989591,6,99814,99938,99902,124,-36,1711
CTCAAG,3.8925635019821696,0.5505739106139971,1.32715752083997,0.965480033088509,6,98577,99939,99903,1362,-36,1712
CTGATG,3.7309389460057205,0.44641482922482795,1.331778052705,0.965447741166729,6,99249,99917,99904,668,-13,1713
GTGACC,3.45511125123735,0.33480818465173495,1.35254028580995,0.9652776250487048,6,99998,99843,99905,-155,62,1714
GTCCTT,3.5663468960277003,0.350690285491698,1.3365503755327401,0.9652718033855501,6,99696,99900,99906,204,6,1715
AAGCTC,3.53478507622343,0.329262046136646,1.33757041402369,0.9651884627721969,6,99779,99896,99907,117,11,1716
TGCCTA,3.5284327844801897,0.584830442749109,1.33757153976229,0.965102932766591,6,99797,99895,99908,98,13,1717
TAACTC,2.99270723729405,0.126532379145228,1.3422770717663703,0.964926765718976,6,101006,99878,99909,-1128,31,1718
TAGGCA,3.5296990860247304,0.00252449740574079,1.33691543419576,0.9646513919141101,6,99796,99899,99910,103,11,1719
GGAGTT,3.88750037882838,0.34184093516254604,1.32562228365577,0.96440302299639,6,98599,99944,99911,1345,-33,1720
GTTATA,2.7118875595327,0.2096340429812,1.33808066391119,0.9643002021496699,6,101247,99891,99912,-1356,21,1721
GAAGTG,3.73035683415662,0.51217728512866,1.33003764693882,0.9641663636494291,6,99252,99927,99913,675,-14,1722
CCTTTA,3.45159573060805,0.400017614132258,1.32686048889733,0.964041581571019,6,100003,99941,99914,-62,-27,1723
CTTGGA,3.72869157787661,0.48704746335308796,1.3295306845758998,0.96376922098722,6,99255,99930,99915,675,-15,1724
TATGGT,3.13005590599071,0.29497421712971,1.3356102352538402,0.9634057591455171,6,100772,99904,99916,-868,12,1725
TTTGCA,3.8729852560230498,0.551811969161809,1.31384138323443,0.963377960781617,6,98660,99979,99917,1319,-62,1726
GGGTCC,3.68501575228785,0.271780270459246,1.35475987589848,0.96324513543408,6,99398,99835,99918,437,83,1727
CTATTT,3.53021950941603,0.336934391834321,1.3125825261929298,0.963234203630514,6,99795,99986,99919,191,-67,1728
CATAGA,3.2951113950623196,0.27228268375854,1.33001265419533,0.962866461171458,6,100387,99928,99920,-459,-8,1729
TACCTG,3.52496724385351,0.264090702797203,1.3341059991356201,0.962523868133548,6,99813,99911,99921,98,10,1730
GAACTT,3.3312856359444303,0.319539014086169,1.3280368614011298,0.962281769772619,6,100302,99933,99922,-369,-11,1731
AGACCT,3.53555062650005,0.173685434992938,1.3326881855284298,0.96168273047732,6,99776,99913,99923,137,10,1732
GTGTAC,2.8920973560097702,0.20888817199631,1.35288761652424,0.961164943796975,6,101127,99841,99924,-1286,83,1733
AGACTT,3.4887735418281096,0.36644166203615597,1.32152600957833,0.960953360113619,6,99914,99956,99925,42,-31,1734
TACAGC,3.3333269540098,0.236004682403662,1.33803128926955,0.9609371463794659,6,100295,99893,99926,-402,33,1735
TGCCCG,3.1540869754900496,0.821988670839165,1.37074733580501,0.960930303501923,6,100725,99782,99927,-943,145,1736
GAGCTT,3.53190848355773,0.322316071162955,1.3315171331803202,0.9608607711057009,6,99791,99918,99928,127,10,1737
CTGACA,3.72696070224443,0.34315723803196696,1.32555347880871,0.960745996296277,6,99258,99945,99929,687,-16,1738
ATAAAG,3.52631858943107,0.5585839608713421,1.30913841324456,0.9605213248041441,6,99805,99997,99930,192,-67,1739
GAATCA,3.4454477128968595,0.461546106607658,1.3222788603209699,0.9605197000348009,6,100024,99954,99931,-70,-23,1740
AAGTTC,3.3243322489211695,0.31905556855871503,1.3257212505898,0.960452804346592,6,100323,99943,99932,-380,-11,1741
AGGTTC,3.3722856882137298,0.12415245976317199,1.33528638628977,0.959967732170282,6,100202,99905,99933,-297,28,1742
TATCCT,3.2567611744318397,0.346910906685711,1.32598144520921,0.959168323956908,6,100467,99942,99934,-525,-8,1743
ATCACA,3.6332156181475,0.5594559262522111,1.31444887736187,0.9587452144692901,6,99542,99976,99935,434,-41,1744
CATCTT,3.6771741871919197,0.458925450829252,1.31294345970203,0.9586642091770071,6,99419,99982,99936,563,-46,1745
CGGGCA,3.1527940330728,-0.28374286008108,1.36753198627668,0.958635501503091,6,100729,99793,99937,-936,144,1746
ACCATA,3.12736689765126,0.48944903694239505,1.3292138087451202,0.9585189645360799,6,100783,99931,99938,-852,7,1747
CCCCCC,4.07383407375222,0.449717063592377,1.3468387003578999,0.9575773943295759,6,97443,99860,99939,2417,79,1748
TGTCAG,3.7197568466570097,0.32590381346405,1.32099924666321,0.957391523529399,6,99276,99957,99940,681,-17,1749
GTAAAA,3.432946819238,0.152359672195544,1.30716377956874,0.957186752075221,6,100058,100001,99941,-57,-60,1750
GCCCTT,3.7594536449695295,0.41496142933757,1.3310534606062099,0.957012253848035,6,99139,99921,99942,782,21,1751
AGGGTG,3.95269563372284,0.5696717306682629,1.32469153554305,0.9568584426190941,6,98224,99947,99943,1723,-4,1752
GCTATA,2.86139926436188,0.195353694791038,1.33516950661073,0.9568417428737791,6,101161,99906,99944,-1255,38,1753
CACTTC,3.7199973905183,0.49075200280301207,1.3201517543065802,0.9566864815880171,6,99275,99960,99945,685,-15,1754
GCTGTA,3.32508221854655,0.23609869387313198,1.33203288394131,0.9565491062235071,6,100320,99916,99946,-404,30,1755
CACCCT,3.95355991392772,0.559102386770514,1.3241438565060801,0.9562864588819421,6,98220,99949,99947,1729,-2,1756
AAGGGC,3.75656048282151,0.420905166573496,1.33009932243578,0.9562467993753531,6,99150,99926,99948,776,22,1757
CTTTAT,3.5204706283773195,0.537279100297264,1.30283364515422,0.955885381342889,6,99823,100011,99949,188,-62,1758
GAGGTA,3.32812611772512,0.21093104485154698,1.33094035410589,0.955827817305517,6,100309,99922,99950,-387,28,1759
GCAACA,3.71317705614906,0.6629115625711679,1.31880291851558,0.95549934936435,6,99300,99964,99951,664,-13,1760
GAATAA,3.3599796386130203,0.418924085018835,1.30679822013299,0.95543229843559,6,100235,100003,99952,-232,-51,1761
CAAACA,3.86325272114929,0.5935956799012491,1.30347761917933,0.9553862145223799,6,98715,100006,99953,1291,-53,1762
CAAGAG,3.8800696091800297,0.47290993788984403,1.3135053341207399,0.955277505027432,6,98632,99980,99954,1348,-26,1763
CAGGTA,3.51707493279633,0.25367347179967004,1.3242912809673602,0.955260793498464,6,99836,99948,99955,112,7,1764
AGTCTG,3.71690196763632,0.35020842127236107,1.31814436764252,0.9552602125008149,6,99283,99965,99956,682,-9,1765
TGGATG,3.7466309685084105,0.4744757596995371,1.31695898092235,0.955090247302251,6,99194,99969,99957,775,-12,1766
GAGTTA,2.9819720103647405,0.121499404850709,1.3287684499663,0.9550711708545071,6,101019,99932,99958,-1087,26,1767
ATACCA,3.27592955176155,0.338215220446328,1.31970635114651,0.9549383528463601,6,100427,99961,99959,-466,-2,1768
TATAGC,2.85875229189038,0.188902689783536,1.33252253413922,0.954883037238428,6,101162,99915,99960,-1247,45,1769
AGAGTG,3.87687955189803,0.47196621074284895,1.31256160697375,0.954623733277066,6,98643,99988,99961,1345,-27,1770
AAGATG,3.66911391189053,0.46604757257961,1.30718302826531,0.9542792185038841,6,99446,99999,99962,553,-37,1771
TGTTGC,3.71062015981837,0.6669600207612291,1.31687725136622,0.954260241706691,6,99309,99970,99963,661,-7,1772
AGGGAT,3.63836437589026,0.564089937980869,1.31910974285566,0.954243730221654,6,99536,99963,99964,427,1,1773
CACAAA,3.8607263508293803,0.5069760589519601,1.30095124885942,0.953483712628052,6,98732,100013,99965,1281,-48,1774
ACCTTT,3.4774791444580697,0.308697600155401,1.3113899061253702,0.9533496728361159,6,99937,99991,99966,54,-25,1775
GCATCC,3.5193581058353196,0.36959185224388397,1.33358138361001,0.953211920031463,6,99829,99912,99967,83,55,1776
AGAGCT,3.84540268139917,0.47100043452933,1.31159583076023,0.953207874369404,6,98800,99990,99968,1190,-22,1777
TTCAAA,3.78355517673521,0.5073024939698351,1.29215240790743,0.953096975538937,6,99061,100043,99969,982,-74,1778
GAAGTC,3.5258514475726606,0.5025850438434369,1.3204454056536001,0.9526817875944079,6,99807,99958,99970,151,12,1779
AGCAAT,3.59434760311487,0.647333112644056,1.30717999283251,0.9526809794443171,6,99630,100000,99971,370,-29,1780
TTATTC,3.3560956672630797,0.5772414514823051,1.3028607350533798,0.952582872971575,6,100248,100010,99972,-238,-38,1781
AGGTCT,3.5217281606577004,0.166293902708091,1.32032680772035,0.9525598299909029,6,99819,99959,99973,140,14,1782
GCTTTA,3.2439898840393,0.39022367767616706,1.31706655244124,0.9524881789530121,6,100503,99968,99974,-535,6,1783
TAACCT,3.08717903696317,0.168924496053425,1.32178337247738,0.9523207555790519,6,100848,99955,99975,-893,20,1784
GGGTTG,3.6233887376193796,0.36313281866211294,1.32779013714118,0.951703104902875,6,99566,99935,99976,369,41,1785
ATCAGT,3.2699578460101897,0.390538693184489,1.3151957334294098,0.9516467279593371,6,100441,99974,99977,-467,3,1786
CAACCC,3.6274689074185495,0.36840562067912697,1.3278389657471599,0.9515115825798531,6,99551,99934,99978,383,44,1787
GGATGC,3.51654981842806,0.362315509322318,1.33109701922667,0.9514735205123811,6,99837,99920,99979,83,59,1788
TCCAAC,3.3928774462758398,0.506289710352364,1.32281792581437,0.951312513714823,6,100156,99952,99980,-204,28,1789
TACCTC,3.3209264701800096,0.166211523516788,1.3249783707608602,0.9512874419420659,6,100329,99946,99981,-383,35,1790
TGGTAT,3.26710064727366,0.329587737162578,1.31458486482789,0.9512457476519209,6,100442,99975,99982,-467,7,1791
CAAGTG,3.90299146481915,0.704536556326808,1.3070743893916101,0.9511349319461049,6,98527,100002,99983,1475,-19,1792
TGATTC,3.4289092086014104,0.45107446826943204,1.30954827338454,0.951027994681462,6,100068,99996,99984,-72,-12,1793
AACATA,3.39055060742199,0.714066952280444,1.2998414124411102,0.95092201748978,6,100163,100015,99985,-148,-30,1794
GTACAC,2.8795223998156803,0.19734558094000798,1.3388515722958898,0.9507741431959599,6,101142,99890,99986,-1252,96,1795
ATCCCT,3.63286552027735,0.268855103637765,1.3144452581358999,0.9506603616280691,6,99543,99977,99987,434,10,1796
TCCACT,3.71185319944071,0.47882637024196706,1.31200756322899,0.950608169263037,6,99306,99989,99988,683,-1,1797
AGCTCT,3.8402776160167797,0.47032010545911296,1.30762905929492,0.9502228305846692,6,98821,99998,99989,1177,-9,1798
ATTGCT,3.5868073615538996,0.531275403405564,1.3030443753236298,0.949614983993992,6,99643,100008,99990,365,-18,1799
TATGTT,3.3878026216394503,0.559437287355213,1.2977246558399098,0.949515699810649,6,100166,100025,99991,-141,-34,1800
TAAAGC,3.2379953486489903,0.286044041546541,1.3126871180046,0.949081325646587,6,100519,99985,99992,-534,7,1801
GGGGGG,4.06022234914846,0.44772422756848107,1.3341987448259198,0.9485818349363839,6,97526,99910,99993,2384,83,1802
AATCAT,3.3491906115828596,0.472748326512718,1.2975707803268302,0.9484721747349181,6,100268,100026,99994,-242,-32,1803
CATAAT,3.1528200066022998,0.39674618217707397,1.30311917280576,0.9484683562130991,6,100728,100007,99995,-721,-12,1804
ATTATG,3.1504471760959305,0.39603260755474395,1.3029926724343999,0.948425568706162,6,100733,100009,99996,-724,-13,1805
GTCCAC,3.2707507717901896,0.21659899528649398,1.3351254583236498,0.9483722027337621,6,100437,99907,99997,-530,90,1806
AGAACA,3.82295180935667,0.459763244862849,1.2947758378899699,0.9482447775280981,6,98896,100034,99998,1138,-36,1807
TGTGTT,3.8502826956929797,0.524683673436096,1.29338515303936,0.948019029006083,6,98782,100038,99999,1256,-39,1808
AACCCC,3.93736142392833,0.48669003415354706,1.31276443040603,0.9476578638224471,6,98316,99984,100000,1668,16,1809
ACTGAT,3.2637612996485603,0.428016333991803,1.3097844291685299,0.947597424629548,6,100452,99995,100001,-457,6,1810
CCAGAT,3.6298109252621202,0.20419169003647603,1.3102323692035902,0.947539965593361,6,99547,99994,100002,447,8,1811
CGTGCC,3.1355455333960403,-0.00585551509432314,1.3522058937110002,0.94744878660083,6,100764,99846,100003,-918,157,1812
GCAACC,3.7440301773532796,0.705359009051827,1.3172450939436298,0.946623792491601,6,99203,99967,100004,764,37,1813
GGAGCA,3.94121988389554,0.327188107087519,1.31096945558074,0.9465918577747071,6,98293,99993,100005,1700,12,1814
CTCTTG,3.86185832628093,0.46254801535501705,1.2998569691908302,0.9450815129679779,6,98726,100014,100006,1288,-8,1815
GCTCTA,3.12075496682523,0.383077739249719,1.32261877751873,0.9450252347600441,6,100792,99953,100007,-839,54,1816
ACAAGC,3.3470983767124802,0.323549197012635,1.3152677792495802,0.944843629776835,6,100279,99973,100008,-306,35,1817
CATATT,3.38355191053098,0.46228587433999896,1.2912276145964299,0.9445809861710079,6,100176,100046,100009,-130,-37,1818
TGAGCT,3.8621183187298103,0.5352554778311729,1.2989586677226101,0.9444274287519779,6,98725,100019,100010,1294,-9,1819
TGTTCT,3.8156046590580694,0.457939534123007,1.28921821068979,0.944229043859252,6,98932,100051,100011,1119,-40,1820
GCTTGT,3.3461024568707596,0.33063117570255895,1.31411784648845,0.944216704781196,6,100280,99978,100012,-302,34,1821
AGCTCA,3.86400112402502,0.522011532656853,1.29859514288282,0.944103814110173,6,98711,100021,100013,1310,-8,1822
GACTCC,3.74689427251302,0.328400541887623,1.31307610330113,0.9437489187367422,6,99192,99981,100014,789,33,1823
TGAAGC,3.69465360313709,0.7001629253301689,1.30252579563862,0.9434105959678399,6,99367,100012,100015,645,3,1824
CTTTCA,3.8167295528862297,0.5225422295259841,1.28809677438294,0.9433357213844571,6,98923,100059,100016,1136,-43,1825
TTTTAC,3.41813398761425,0.13737201166926702,1.28765965800338,0.9427152003867829,6,100097,100061,100017,-36,-44,1826
TGACAA,3.49133480065573,0.492061122237335,1.29634956899136,0.942646868819015,6,99905,100030,100018,125,-12,1827
GGAGTC,3.74443723855308,0.327564937178812,1.31134628567203,0.942548743149537,6,99202,99992,100019,790,27,1828
GGGTCA,3.61326264973141,0.322658302540551,1.3154177191182,0.942494989369117,6,99590,99972,100020,382,48,1829
CATCCA,3.7318002907274996,0.48266901463342704,1.29919723009543,0.9416987867160809,6,99241,100018,100021,777,3,1830
GGGGTT,3.9293721939463504,0.486429137304933,1.30380794551823,0.9413208431110419,6,98380,100005,100022,1625,17,1831
TGACCC,3.61017311901088,0.319687454798805,1.31278950747449,0.940440123884688,6,99596,99983,100023,387,40,1832
CAGACT,3.6997357902964403,0.314512977060234,1.2983285668607198,0.940432212879039,6,99354,100022,100024,668,2,1833
TTTGTC,3.64995166700121,0.5555334449866329,1.28796726964633,0.939969834447265,6,99497,100060,100025,563,-35,1834
CATTTG,3.84166151953315,0.550083822084819,1.28251764674452,0.9397890055035971,6,98815,100078,100026,1263,-52,1835
TTGGAG,3.8542145382455097,0.308555094579672,1.2923364430728899,0.9394941199177841,6,98762,100041,100027,1279,-14,1836
AATAGC,3.2250058526745202,0.36556564305626293,1.29969762203012,0.939408704396342,6,100562,100016,100028,-546,12,1837
TAAAGG,3.41652184776859,0.256589212022496,1.29372563003547,0.93921745251385,6,100099,100036,100029,-63,-7,1838
GGCACG,3.1256283650000296,1.1648556342563001,1.3403663182039098,0.938885400135967,6,100787,99883,100030,-904,147,1839
CCTCCG,3.1568957833206404,1.2055075347275201,1.33889886772443,0.9386223134280022,6,100717,99888,100031,-829,143,1840
AATATG,3.37155262267908,0.452069952879574,1.2830897578332099,0.938380756197885,6,100205,100076,100032,-129,-44,1841
ACCCTA,3.14314135097198,0.521116253704678,1.31257731628967,0.938260745150368,6,100746,99987,100033,-759,46,1842
GTTGAA,3.48355374348552,0.5451493131345,1.2900295998554099,0.937987778440768,6,99925,100049,100034,124,-15,1843
TTGTCA,3.48694061307868,0.47013645812931204,1.28955503835989,0.937719542635428,6,99921,100050,100035,129,-15,1844
GGTTGC,3.73260149953333,0.70124841261814,1.3045252381939298,0.9374388985467831,6,99237,100004,100036,767,32,1845
CCTTCA,3.88243679609921,0.646347896013271,1.2886356473994098,0.937251919955287,6,98622,100056,100037,1434,-19,1846
TAGCTT,3.22335609220596,0.40226549143001794,1.2964327606078998,0.937121876705282,6,100568,100028,100038,-540,10,1847
GCTATT,3.22317839340496,0.367513650689625,1.2962550618069,0.936989210576563,6,100570,100031,100039,-539,8,1848
TTCAAC,3.4870140514467995,0.7007312398537341,1.2881673886937501,0.9366136173288689,6,99920,100057,100040,137,-17,1849
CAGTAT,3.2496336885781605,0.20800936535367,1.29487157599738,0.9365043744455959,6,100488,100033,100041,-455,8,1850
TTGAAG,3.6183289386541597,0.46627539263336704,1.28413575444352,0.9364729787598359,6,99581,100072,100042,491,-30,1851
TAAGTA,2.95185691161862,0.402732415662252,1.29182532003424,0.9360785368937191,6,101053,100044,100043,-1009,-1,1852
GACTTC,3.50234096166223,0.468693462156685,1.29809321366025,0.9360470328213369,6,99880,100023,100044,143,21,1853
CAATGG,3.64457638508401,0.41384477674549697,1.29372262154614,0.9359651121959691,6,99518,100037,100045,519,8,1854
TGCTCC,3.9235717120177798,0.31172642331765005,1.2964019847311499,0.935703129570516,6,98420,100029,100046,1609,17,1855
TACTTA,2.9500600257817697,0.595042188553853,1.29118672811448,0.935584389841493,6,101056,100047,100047,-1009,0,1856
TGCAAC,3.56011724366809,0.66108717660854,1.29514457790787,0.935123915514244,6,99714,100032,100048,318,16,1857
GACAAA,3.6457219498654903,0.46631458237221995,1.28154473610527,0.934992554461641,6,99514,100082,100049,568,-33,1858
CCTTGA,3.68868763709693,0.4585268642796911,1.29048437660686,0.934568614147677,6,99389,100048,100050,659,2,1859
CATATG,3.44393258397571,0.6230291369004699,1.28548228503398,0.933811072788399,6,100027,100068,100051,41,-17,1860
CTCCAA,3.84425257070383,0.300148385964548,1.28482394737805,0.9336352864311992,6,98807,100070,100052,1263,-18,1861
TGTGCA,3.9078075697949397,0.513836214395875,1.28253769399914,0.9334313125861948,6,98512,100077,100053,1565,-24,1862
ACTTGC,3.33283883675152,0.405438172679601,1.29939313833496,0.933233629867601,6,100296,100017,100054,-279,37,1863
TGAAGG,3.87276422670049,0.6183861444292039,1.28314843211329,0.933146476167568,6,98662,100075,100055,1413,-20,1864
CGGAGG,3.14858208475132,-0.7864461478521021,1.33123301520296,0.933135309934524,6,100736,99919,100056,-817,137,1865
AGATAT,3.25525927850398,0.43687977949732104,1.27908746350181,0.9331117967010021,6,100472,100087,100057,-385,-30,1866
TGACCA,3.5572508409078902,0.297698432263713,1.29227817514767,0.932992009315312,6,99720,100042,100058,322,16,1867
ATGATT,3.33133154430551,0.46437751621311,1.2765350248718101,0.93283288509537,6,100300,100095,100059,-205,-36,1868
TACCTA,3.0206428404727994,0.62658264270183,1.2966011726089899,0.9327098237658641,6,100964,100027,100060,-937,33,1869
TCAATA,3.1738416072909903,0.449272082790223,1.28029188774386,0.932284508938629,6,100690,100084,100061,-606,-23,1870
TGGACA,3.71835825787237,0.427145770168288,1.2864399401513,0.932261159791745,6,99278,100065,100062,787,-3,1871
AACAGT,3.4780422182630004,0.38577424633057705,1.28227174449788,0.9321348644288,6,99936,100079,100063,143,-16,1872
TCAAGG,3.68165292841312,0.448571994761519,1.2869502791246599,0.931853569046218,6,99406,100063,100064,657,1,1873
GTATTC,3.05163908866081,0.49825725592844,1.2940364515137701,0.931653177068037,6,100916,100035,100065,-881,30,1874
AACACA,3.8306836523599,0.509253365236704,1.27090855038994,0.9308738435274209,6,98861,100115,100066,1254,-49,1875
GCAGTA,3.26145479280422,0.212643927133765,1.29775825856723,0.9304518323685121,6,100457,100024,100067,-433,43,1876
GTTGCA,3.5516511538730198,0.5951375103077761,1.2881395761470602,0.92998491911324,6,99731,100058,100068,327,10,1877
AGACTA,3.0577950811281496,0.377216044871549,1.29124112272527,0.9296650181164341,6,100904,100045,100069,-859,24,1878
CAAATG,3.82657688471959,0.5591661736065601,1.26904811288464,0.929523544879799,6,98883,100124,100070,1241,-54,1879
CTTATT,3.3304081562133505,0.393509386549828,1.27084128469915,0.928659760919486,6,100305,100116,100071,-189,-45,1880
TAGGGT,3.1275404793657797,0.22466263715582396,1.2987614557416598,0.928236625388934,6,100781,100020,100072,-761,52,1881
TGGTCA,3.54914974552728,0.281067632447407,1.28563816780132,0.9281248571813442,6,99742,100066,100073,324,7,1882
GGTTTT,3.7923273996586095,0.11693486079079901,1.26722250712492,0.9277045088275581,6,99027,100130,100074,1103,-56,1883
CTAAAA,3.71629667677104,0.10446232594408801,1.25926643331728,0.9275242090215979,6,99286,100163,100075,877,-88,1884
TGTCTA,3.2433514811854303,0.533290580296857,1.28206065767746,0.927159078643585,6,100504,100080,100076,-424,-4,1885
TAGGTA,3.0125722441820098,0.44995068827295503,1.28885449934212,0.9270577403797821,6,100979,100055,100077,-924,22,1886
TAGTCT,3.0514280959392703,0.229810763520913,1.28749351948774,0.926937149003343,6,100917,100062,100078,-855,16,1887
TCAGTT,3.60253705894258,0.37274089377900804,1.26990546195595,0.925782736525427,6,99615,100122,100079,507,-43,1888
AACTGT,3.4374826440306903,0.19357971686826003,1.27446959468593,0.9256780827118399,6,100046,100101,100080,55,-21,1889
GCTTCA,3.6745614781035094,0.619200457917678,1.2785722395163601,0.9256444965736121,6,99428,100090,100081,662,-9,1890
TATTGA,3.16787643524939,0.442208287268151,1.27115002752458,0.9256027000117379,6,100696,100114,100082,-582,-32,1891
ATACTG,3.23377699631032,0.20087011131972302,1.27980012583029,0.9252667130334922,6,100534,100086,100083,-448,-3,1892
AAGTAT,3.1555706907663197,0.49591550817161,1.2707960122814,0.925043433217427,6,100720,100118,100084,-602,-34,1893
ACAGTT,3.44059336415775,0.172978626292961,1.27334583190796,0.924926334103298,6,100037,100105,100085,68,-20,1894
GGCCTT,3.9077509221447904,0.507844016113738,1.28186275069275,0.9249169583836809,6,98515,100081,100086,1566,5,1895
TGCAAA,3.82033778694975,0.505847339727614,1.2628090151147902,0.9248313039628729,6,98906,100151,100087,1245,-64,1896
CTTAGA,3.2121558166965802,0.0898239369046259,1.27981450024995,0.9248163850521941,6,100609,100085,100088,-524,3,1897
AGTGCA,3.8673318661298,0.637357389402929,1.27141479070226,0.9244566872684151,6,98688,100113,100089,1425,-24,1898
AGTATA,2.93625044893947,0.28062836467387,1.27621885735509,0.9244419095070359,6,101078,100096,100090,-982,-6,1899
CAGTAA,3.4676991377208597,0.3754311657884411,1.27192866395575,0.9244036828570871,6,99963,100109,100091,146,-18,1900
CTTGCC,3.90829452119454,0.5283836968947321,1.28112479390792,0.924348347107674,6,98511,100083,100092,1572,9,1901
AAAACC,3.78522127828314,0.108218557259669,1.2630226646328602,0.9242050681821379,6,99051,100149,100093,1098,-56,1902
TATACT,2.93475483751085,0.280291047162336,1.2758815398435601,0.924173258828077,6,101080,100097,100094,-983,-3,1903
TTCCAA,3.7863767475558197,0.5687790450506011,1.2625630329518702,0.9239907596919058,6,99048,100153,100095,1105,-58,1904
CATGAG,3.86664666865193,0.507026403332945,1.2707295932243898,0.923944330789905,6,98696,100119,100096,1423,-23,1905
GCAAGC,3.52146491849293,0.462621567265339,1.29249174519593,0.923882198234133,6,99820,100040,100097,220,57,1906
TACTGC,3.2513928389124103,0.11145608042230198,1.2888545985925102,0.9238513159937259,6,100482,100054,100098,-428,44,1907
ATACTT,3.15686966570448,0.488080281931348,1.2690187982316201,0.9237819747946461,6,100718,100125,100099,-593,-26,1908
GGATTT,3.55084353109124,0.155861113333655,1.2683621006955499,0.923656001123487,6,99740,100128,100100,388,-28,1909
TGCACT,3.86510634987196,0.6362901670621689,1.2703475683615,0.923641439808923,6,98705,100120,100101,1415,-19,1910
AAGCTA,3.2038044939992596,0.5084746884122341,1.27849626335487,0.9236322863787628,6,100631,100091,100102,-540,11,1911
AAAGGT,3.4356291649226804,0.34089640475481503,1.27145782166082,0.9234459993034909,6,100049,100111,100103,62,-8,1912
TTCTTG,3.78787433704839,0.43020921211333096,1.2614878886801202,0.923375412778133,6,99047,100156,100104,1109,-52,1913
GTCACA,3.54399646174989,0.48049587377537295,1.27823855388892,0.9225720470869928,6,99756,100092,100105,336,13,1914
GGCAAG,3.9089060790874304,0.526768696183755,1.2786556507726399,0.922566827940515,6,98508,100089,100106,1581,17,1915
CTTATA,2.9325878720385896,0.26379848826546,1.2737145743713,0.9225581878786221,6,101082,100103,100107,-979,4,1916
AGTGAT,3.55114195987984,0.663682846667687,1.26622067973248,0.9220513628792221,6,99735,100134,100108,399,-26,1917
CATGGG,3.93621690518677,0.269307664660621,1.27661367650372,0.921731809625245,6,98325,100094,100109,1769,15,1918
GGTAGG,3.51386614118471,0.44725283533166604,1.2889954666035,0.9213683989396779,6,99844,100053,100110,209,57,1919
GGCACC,3.9807571238315695,0.5346096646484589,1.2864966192373402,0.921362762525673,6,98051,100064,100111,2013,47,1920
ATCACT,3.5511124556319,0.47897390851615995,1.26510313926662,0.921147273731285,6,99737,100137,100112,400,-25,1921
CCATTG,3.6226415944538504,0.387509486774555,1.27371023802707,0.921029281401957,6,99567,100104,100113,537,9,1922
CCCATG,3.9352055629857006,0.261986192681972,1.27527841127873,0.9206525211022609,6,98333,100099,100114,1766,15,1923
AACTGA,3.5945529630087996,0.382273293922536,1.26313317366893,0.9205833495998259,6,99629,100147,100115,518,-32,1924
AATAAG,3.3192936072292296,0.429163737797982,1.2601835427516201,0.9205461270594759,6,100333,100161,100116,-172,-45,1925
AGTAAT,3.0845698020563597,0.425689161203961,1.26646809876309,0.920444543125111,6,100852,100132,100117,-720,-15,1926
TATAAG,2.93083067522624,0.271175492631533,1.2707990836418601,0.920403416393746,6,101084,100117,100118,-967,1,1927
AGATCA,3.5508606655647403,0.45637380134184,1.2636930552823702,0.9201097984273771,6,99739,100144,100119,405,-25,1928
ATTAAC,2.8865438956306,0.34329498496903493,1.27172863882476,0.920100030341692,6,101132,100110,100120,-1022,10,1929
ATACCT,3.1972268114059705,0.28890411591768106,1.27376103521128,0.9200777152575369,6,100646,100102,100121,-544,19,1930
TGATCT,3.54690118868738,0.461765418856343,1.26313820245711,0.9197271433809809,6,99748,100146,100122,398,-24,1931
GAATCT,3.35883298054315,0.252578049955936,1.2684215523876101,0.9196592154992059,6,100238,100127,100123,-111,-4,1932
GCTAAC,2.94320028279845,0.23670313931693,1.2927701172707702,0.9195423205418399,6,101069,100039,100124,-1030,85,1933
GGTGCC,3.97568106815596,0.530925796683562,1.28366689369675,0.919327927665865,6,98080,100073,100125,1993,52,1934
CTCATG,3.85877256699409,0.487430175257664,1.2640137854836297,0.9189063715182559,6,98740,100143,100126,1403,-17,1935
ATTACT,3.08109015813523,0.424369313537005,1.26414674875904,0.918691949514652,6,100858,100142,100127,-716,-15,1936
CCTACC,3.51107677738559,0.436477475468866,1.28555825675652,0.918648691588956,6,99852,100067,100128,215,61,1937
GTTAAT,2.8842064899090696,0.34039758204524206,1.26939123310322,0.9184591192649129,6,101135,100123,100129,-1012,6,1938
TGAAAG,3.78043162250273,0.503947528797813,1.2545019811710298,0.918011843109466,6,99071,100178,100130,1107,-48,1939
CAAGAA,3.7823632334163704,0.41917466892254396,1.25418726194967,0.9177271698313341,6,99064,100181,100131,1117,-50,1940
AGATTA,3.0808815698589105,0.307669496947693,1.2627798665656298,0.917688373093448,6,100860,100152,100132,-708,-20,1941
AATTTC,3.5440391361141605,0.30476856700536104,1.24979584272013,0.9173751136951579,6,99754,100194,100133,440,-61,1942
GAAATT,3.54546243076331,0.295899319217568,1.24965755014527,0.9172954603554291,6,99752,100196,100134,444,-62,1943
GCTTGC,3.5138731341081204,0.46677130068389505,1.28328485985745,0.9172435679830641,6,99843,100074,100135,231,61,1944
CATGTA,3.42153873685632,0.5765221335841679,1.2630884379146001,0.9170846431055408,6,100087,100148,100136,61,-12,1945
TTTTAG,3.70646487379992,0.09475848818761,1.2450461345217299,0.9170484399519029,6,99328,100215,100137,887,-78,1946
CTCATC,3.6661981477347796,0.489768901297094,1.26635251152306,0.916576039070871,6,99453,100133,100138,680,5,1947
TAATCT,3.0781875343744503,0.304957996450904,1.26124412499826,0.916523281646024,6,100870,100159,100139,-711,-20,1948
AACAGC,3.6600283010158394,0.16362755651646801,1.2656541633823601,0.915882835478932,6,99470,100136,100140,666,4,1949
GATGTG,3.6938278403343703,0.4954543731450479,1.26415585274831,0.915701251422736,6,99370,100141,100141,771,0,1950
CCTAAA,3.38545864648212,-0.143120068768514,1.26233850572507,0.915700166666096,6,100169,100154,100142,-15,-12,1951
GATGAG,3.6651562344165898,0.501133857307346,1.26483704719879,0.9155433808474029,6,99456,100138,100143,682,5,1952
ATTGTA,3.1059973916999,0.46086287536390297,1.2585428880383602,0.9151710800374201,6,100810,100165,100144,-645,-21,1953
TATGAA,3.34007466049769,0.428384482928854,1.25161179565182,0.9147428078670329,6,100289,100190,100145,-99,-45,1954
TGTCCA,3.69266400206065,0.405523959148072,1.2623072715635801,0.914245806347636,6,99376,100155,100146,779,-9,1955
TGCACA,3.8843186195011197,0.501809462460654,1.25680241357031,0.914130936664799,6,98611,100171,100147,1560,-24,1956
CTTCAA,3.58438350243245,0.42512554881301595,1.2545253003165802,0.9141132110954291,6,99649,100177,100148,528,-29,1957
ATCAGC,3.42330037229519,0.16790798898016002,1.2699345958460502,0.913987978543408,6,100078,100121,100149,43,28,1958
CTGATA,3.1970915552960197,0.164184670305422,1.2647502388493899,0.913613020999362,6,100647,100139,100150,-508,11,1959
AATGGT,3.45087200647058,0.417657260401636,1.25734786284047,0.9135601648849341,6,100009,100170,100151,161,-19,1960
TATCAG,3.19629879981955,0.154674476595069,1.2643607766798401,0.913315460758,6,100649,100140,100152,-509,12,1961
GTCCAT,3.2600603732947,0.29640246917303004,1.27288731493775,0.912596464790195,6,100461,100108,100153,-353,45,1962
AAATTG,3.49064053315944,0.259788573426613,1.24410755660468,0.912172899868518,6,99907,100217,100154,310,-63,1963
GGCAAA,3.84684426695561,0.360335787321812,1.2549821422334,0.9120421098875501,6,98795,100174,100155,1379,-19,1964
TGTGCT,3.8471165418961,0.48590261091738,1.25460409052064,0.9119257342516189,6,98792,100176,100156,1384,-20,1965
ATTAAG,3.0727569801189305,0.22067962600860502,1.2546552768256598,0.9116194197072479,6,100880,100175,100157,-705,-18,1966
GACTGC,3.51153471125934,0.194035886150914,1.2755284521601,0.9115906130286651,6,99851,100098,100158,247,60,1967
TTTAGG,3.38066365613409,-0.14645544542507402,1.25625233744729,0.911381637074268,6,100184,100173,100159,-11,-14,1968
AACAAC,3.45141206839143,0.7051823986060609,1.25418050659205,0.9110779895541049,6,100006,100182,100160,176,-22,1969
TACAAT,3.102820771197,0.522776223707398,1.25311993740046,0.911068082692544,6,100819,100187,100161,-632,-26,1970
AGGTTA,3.0309094131813503,0.11910327084142999,1.26581654281273,0.9108823621095641,6,100952,100135,100162,-817,27,1971
CTTAAT,3.07061049268816,0.215033499774751,1.2536670833119699,0.910863452234537,6,100886,100184,100163,-702,-21,1972
GTTGTT,3.44838556760444,0.458543464376874,1.2532463230206499,0.9106318336742629,6,100013,100186,100164,173,-22,1973
AGGTAT,3.1838487058223097,0.281336975139498,1.2606857237447902,0.9104447558873942,6,100670,100160,100165,-510,5,1974
TTTGCC,3.8436075367046203,0.353082160279017,1.25205271813982,0.9099556394459659,6,98810,100189,100166,1379,-23,1975
GGTCCC,3.77381714689583,0.238919288998149,1.27671611773535,0.909744796424505,6,99094,100093,100167,999,74,1976
TACATG,3.4115538269218795,0.42461883675060397,1.25310352798016,0.909631288040359,6,100112,100188,100168,76,-20,1977
AGAATC,3.57949144028973,0.41346235122965797,1.24847494425678,0.909600961016636,6,99662,100204,100169,542,-35,1978
AGCACA,3.8494746653,0.49631830862778,1.2513112597374398,0.909382666196788,6,98785,100191,100170,1406,-21,1979
GCTGAT,3.4144996293837298,0.16744599300141,1.26338018306959,0.909184105141929,6,100104,100145,100171,41,26,1980
TCAGTC,3.4652302061597995,0.36422118328779296,1.26138575146474,0.9087874558289529,6,99969,100157,100172,188,15,1981
GACTGA,3.4671043989433903,0.38043518397101095,1.26129506371741,0.9087554618260871,6,99966,100158,100173,192,15,1982
GCTAAA,3.1836934544530298,-0.102608134880166,1.25838522380864,0.908680367926892,6,100671,100166,100174,-505,8,1983
TTTAGC,3.1847748334067796,-0.10968213957641698,1.25785150180871,0.90842345494117,6,100667,100169,100175,-498,6,1984
GGGACC,3.77337052079791,0.239472477208517,1.27470790441342,0.9082961515722691,6,99095,100100,100176,1005,76,1985
TGGTAG,3.4915219984869506,0.41991894882541203,1.25960955126425,0.9081613521880859,6,99904,100162,100177,258,15,1986
CAATTT,3.48902987938902,0.262987337386962,1.23863547174557,0.908135865932456,6,99912,100237,100178,325,-59,1987
GCTGTT,3.6476145369901403,0.15793743846981198,1.253871628538,0.907300758016953,6,99508,100183,100179,675,-4,1988
CATACA,3.41011166373681,0.489928869229997,1.24941503466008,0.90682871152343,6,100118,100197,100180,79,-17,1989
CTACTT,3.41453841312942,0.552667049732234,1.24844917479673,0.9063197366611129,6,100103,100206,100181,103,-25,1990
TCTAAG,3.18642838280589,0.0738506729443813,1.2544903596661698,0.905978072473396,6,100666,100179,100182,-487,3,1991
GCAGTC,3.50348792006714,0.18277062284134601,1.26788495427481,0.905949008856789,6,99874,100129,100183,255,54,1992
CTACCT,3.458115435634,0.452508172324755,1.25641128857948,0.9050049072813191,6,99987,100172,100184,185,12,1993
TGTATG,3.4020452280025695,0.487824121008524,1.24584125919586,0.904262659354583,6,100137,100212,100185,75,-27,1994
CAGACC,3.72477594851193,0.274384765079207,1.25820035487969,0.903774749841672,6,99267,100167,100186,900,19,1995
AGTCAT,3.3364956424131806,0.421665053750461,1.24648750756457,0.9032986516036271,6,100293,100211,100187,-82,-24,1996
TCTATG,3.21096022430426,0.196045300011892,1.24966940079629,0.9030613835972751,6,100613,100195,100188,-418,-7,1997
AGGTAG,3.4562032095328,0.458042446044425,1.25364356267836,0.903057923415496,6,99995,100185,100189,190,4,1998
ATGGAC,3.2473789567143303,0.47152876189049,1.25906873334706,0.90240496615316,6,100494,100164,100190,-330,26,1999
GACCCC,3.76578312845905,0.44072219279815705,1.2667965890506399,0.9023854201657351,6,99114,100131,100191,1017,60,2000
GTTAGC,2.92173003527659,0.21677850978304603,1.26852647487816,0.9019133924157059,6,101094,100126,100192,-968,66,2001
GAAGTA,3.18247397564066,0.43111400346677603,1.2489743652769298,0.9019057418820849,6,100674,100200,100193,-474,-7,2002
AAGTAA,3.3589859555161397,0.533143166720068,1.23320291584688,0.901605149113388,6,100237,100252,100194,15,-58,2003
CACCCG,3.07470150279994,0.7888279916122299,1.28911553297989,0.9015939246339141,6,100874,100052,100195,-822,143,2004
TACTTC,3.1788880692915202,0.41013050417066105,1.24810834006889,0.901217858448143,6,100683,100207,100196,-476,-11,2005
GAAATC,3.40854494811239,0.28776897885821695,1.24152720978592,0.901116316052027,6,100123,100227,100197,104,-30,2006
ACTGTT,3.4371215251363902,0.35875309734161803,1.2405211925183501,0.901063523158909,6,100047,100231,100198,184,-33,2007
AAGTAG,3.40539475743377,0.5411636650451029,1.2412234141719098,0.900877106078545,6,100131,100230,100199,99,-31,2008
GCAGTT,3.61017574972473,0.16067131020737502,1.24578564164084,0.900624786779082,6,99595,100213,100200,618,-13,2009
TCTAAC,2.90487111798963,0.10112185157687599,1.25444095246195,0.8998859162401379,6,101111,100180,100201,-931,21,2010
ATGACT,3.3321381054936303,0.42956916867939793,1.2417266773381002,0.899760460330393,6,100298,100226,100202,-72,-24,2011
TGTGAC,3.5099465639966603,0.478518748768185,1.24722022837145,0.8995693306531659,6,99857,100209,100203,352,-6,2012
CGGGGT,3.10223382648095,-0.0177977723940366,1.28488475693259,0.8995564855399041,6,100823,100069,100204,-754,135,2013
TGTAAC,3.04497071479355,0.34191526567911995,1.24906395602241,0.899079191143713,6,100928,100198,100205,-730,7,2014
GTTACA,3.0456801862670804,0.31258823073656,1.2489881853951998,0.899039573991441,6,100927,100199,100206,-728,7,2015
ACCCCG,3.1023352628644103,0.7070844762626078,1.2843383472682,0.898946953081851,6,100821,100071,100207,-750,136,2016
CCGGGC,3.8019141898902404,0.36386049377020896,1.2730546496325,0.8989024544163721,6,98988,100106,100208,1118,102,2017
GCCCGG,3.8019141898902404,0.35696261836385496,1.2730546496325,0.8989020899323671,6,98989,100107,100209,1118,102,2018
ACACTA,2.9714087013518,0.39347558189216,1.25099110172827,0.8987930240821309,6,101030,100192,100210,-838,18,2019
TCCATA,3.2070737181029703,0.42700834899798296,1.24353656445999,0.8984512001535949,6,100623,100221,100211,-402,-10,2020
CCAGTA,3.4100132877437206,0.142464164226981,1.2485048433940902,0.898283027795521,6,100119,100203,100212,84,9,2021
TGAGCA,3.83186864023032,0.472248374911336,1.23595156480278,0.8979623507428101,6,98851,100241,100213,1390,-28,2022
TAGTGT,2.96815501641052,0.212759696438285,1.2488254530049099,0.89736929708297,6,101032,100202,100214,-830,12,2023
ACTACT,3.01296090636478,0.29909778514222807,1.24756524187899,0.897272980186799,6,100978,100208,100215,-770,7,2024
TGATCC,3.59040940672853,0.504995826557749,1.24147805030174,0.897056413198981,6,99636,100228,100216,592,-12,2025
TGATGC,3.39788555176857,0.381813046979834,1.2467661054544399,0.8968746188905209,6,100148,100210,100217,62,7,2026
CCATAT,3.27945204985004,0.344540716905948,1.23927015856844,0.896857924468419,6,100421,100234,100218,-187,-16,2027
GCCCAA,3.6767832356376497,0.333906120959361,1.249998152228,0.896849434625853,6,99420,100193,100219,773,26,2028
TTACTT,3.35666221945415,0.53040576477879,1.22618788984328,0.8965348268256129,6,100244,100277,100220,33,-57,2029
CAACCA,3.51030544610354,0.282175414932009,1.24308645020831,0.896398245150576,6,99854,100222,100221,368,-1,2030
GGGGTC,3.75478581538631,0.440629901036456,1.2580087092497498,0.896085686887369,6,99159,100168,100222,1009,54,2031
CTACAT,3.1648848348570495,0.234895723343872,1.2414190586623601,0.8960446945157919,6,100705,100229,100223,-476,-6,2032
GCATCA,3.3989626482084603,0.37182752925477797,1.24559687175932,0.8959553277179259,6,100143,100214,100224,71,10,2033
ACCATT,3.4318490348050803,0.3932376002493139,1.23300237205204,0.8954027045781859,6,100061,100254,100225,193,-29,2034
AGTAAC,3.01150249784984,0.524456609486382,1.24494853944696,0.8953541019653979,6,100981,100216,100226,-765,10,2035
GGAATA,3.3576338683101703,0.40381784562341705,1.23483765057705,0.8952784998112661,6,100242,100248,100227,6,-21,2036
GCTACA,3.24414161678717,0.227199467994458,1.24884595204693,0.8949608432622841,6,100502,100201,100228,-301,27,2037
TATGGA,3.2015645020749104,0.23638258166352696,1.23871209134293,0.894942892856044,6,100635,100236,100229,-399,-7,2038
CGGGTG,3.0620746496577698,-0.288039057981935,1.27905893299666,0.894474883725879,6,100899,100088,100230,-811,142,2039
GATCAT,3.1649436070938997,0.41411177613765204,1.23893422995176,0.894298823366598,6,100704,100235,100231,-469,-4,2040
TGGTTG,3.5008485175460295,0.26311483269974,1.23958326995507,0.8939698342722701,6,99884,100233,100232,349,-1,2041
CAAGCA,3.8288047774086897,0.570794491657686,1.23064137184614,0.893948433463317,6,98872,100260,100233,1388,-27,2042
GTATCT,3.16022225410147,0.569117510437545,1.2382175659410402,0.893735459027491,6,100712,100238,100234,-474,-4,2043
TAGATG,3.19962498998138,0.182214780074363,1.2367725792494,0.8935011026774359,6,100640,100240,100235,-400,-5,2044
ATGATC,3.16368384376277,0.42551695796193195,1.2376744666206299,0.8933624315299541,6,100708,100239,100236,-469,-3,2045
ACTAAT,2.88494854459997,0.24999937840351702,1.23451837907229,0.8931450702630842,6,101133,100249,100237,-884,-12,2046
TGCTCA,3.8242023797784706,0.452859988042045,1.22944359826801,0.893086820538131,6,98892,100263,100238,1371,-25,2047
GGATCA,3.58655165575033,0.485607405900305,1.23569789221246,0.8927933954128779,6,99645,100244,100239,599,-5,2048
ATATGG,3.27334287384017,0.333026965357954,1.23348490558249,0.892637364154647,6,100433,100251,100240,-182,-11,2049
CATCTA,3.19881372580149,0.48650649477790997,1.23527657215851,0.892312801356451,6,100644,100247,100241,-397,-6,2050
TATTCC,3.35546313958014,0.401786157612992,1.2307278978694198,0.89226710146702,6,100251,100259,100242,8,-17,2051
TGCTTG,3.8207627608163,0.580758326634797,1.2282503094408501,0.892245707835148,6,98905,100265,100243,1360,-22,2052
GTTAGA,2.89692648841854,0.0979069037777229,1.2437229280201,0.892121866474095,6,101119,100220,100244,-899,24,2053
TGGGTT,3.8191714356615605,0.220634528277595,1.2279405401206898,0.8920329974233759,6,98913,100268,100245,1355,-23,2054
GGTCTG,3.70442192233738,0.274042222717918,1.24197816908807,0.891889762235693,6,99336,100225,100246,889,21,2055
AACCCA,3.82013176213404,0.214653495791151,1.22794571438791,0.891773690780832,6,98907,100267,100247,1360,-20,2056
TTGGGC,3.6706580654088596,0.19361951176853898,1.24258180406946,0.8916005068056742,6,99442,100223,100248,781,25,2057
GAATAC,3.00055402334306,0.484771919135323,1.23992871093777,0.8915118045722491,6,100996,100232,100249,-764,17,2058
GTTAGG,3.0772491890700797,0.13963553500056303,1.24847016544596,0.89118252076156,6,100872,100205,100250,-667,45,2059
CAACTG,3.5007712825803594,0.17744869773345298,1.2357986168201398,0.89104193904562,6,99885,100242,100251,357,9,2060
ATTAGT,2.88443364647771,0.248220158880434,1.23123008607927,0.8908518258480291,6,101134,100257,100252,-877,-5,2061
CTTAGC,3.2066260104248703,0.17836218978017698,1.24408777010498,0.8907912283232321,6,100624,100218,100253,-406,35,2062
TTGTAG,3.3933080794909,0.40810305504479105,1.2275216352753702,0.8907907421522769,6,100154,100271,100254,117,-17,2063
GCTAAG,3.20755030054632,0.19222471361604898,1.24385376630934,0.890637311323815,6,100620,100219,100255,-401,36,2064
ATGTAG,3.15711549181912,0.225114941609862,1.2339525097416002,0.8905855572977379,6,100716,100250,100256,-466,6,2065
CTACCA,3.47016059168373,0.395934248406132,1.23569902020886,0.8902857114208109,6,99955,100243,100257,288,14,2066
TGTAGC,3.2353966141515698,0.213318302076248,1.2423472795463302,0.8902158754540971,6,100526,100224,100258,-302,34,2067
TTACTG,3.42038574182218,0.3420173140274069,1.2237854092041398,0.888575095514214,6,100089,100283,100259,194,-24,2068
AGATTC,3.3161944550964906,0.206655296074638,1.22618632024788,0.888178177495871,6,100340,100278,100260,-62,-18,2069
GATTCT,3.5519454433876803,0.387631876527351,1.2189105530941398,0.88762191561288,6,99729,100295,100261,566,-34,2070
CACTTG,3.81659523355647,0.6182237372882929,1.22183645204601,0.8874106340102579,6,98924,100286,100262,1362,-24,2071
TGTGAA,3.7680336174096,0.44404969610638595,1.2127511757096499,0.8872730801422439,6,99108,100310,100263,1202,-47,2072
GGTGAA,3.8113235743736404,0.532781885752556,1.22170777978644,0.887249717253208,6,98955,100288,100264,1333,-24,2073
CAGTTG,3.4938642980523102,0.152019200092626,1.23035272032635,0.8870699098216229,6,99898,100261,100265,363,4,2074
ATTAGG,3.11179149181775,0.0168575896193239,1.23000363526897,0.8867977558488259,6,100803,100262,100266,-541,4,2075
ATAATT,3.3819927176893403,0.634151421820778,1.2015857441417501,0.885972096709505,6,100180,100352,100267,172,-85,2076
CAGATC,3.4663800902114397,0.24555932798863198,1.22937491778912,0.8856968284657339,6,99968,100264,100268,296,4,2077
AAAGCC,3.7810988049971903,0.292121781314457,1.22051188775431,0.8856432623264742,6,99070,100291,100269,1221,-22,2078
ATCCCC,3.6192043146136403,0.19906131332573399,1.23561568227568,0.885302871873478,6,99578,100245,100270,667,25,2079
ATAGAA,3.42573230603154,0.37353953681790797,1.20855212984503,0.8848416122668101,6,100071,100322,100271,251,-51,2080
TTCACA,3.77073381783168,0.45435066379838707,1.20934361490805,0.8847477750389681,6,99103,100318,100272,1215,-46,2081
CCTAAT,3.1092320600298304,0.0141217554012627,1.2271202804571202,0.884574950375973,6,100804,100273,100273,-531,0,2082
AATGGG,3.80692881203022,0.21000700559992302,1.21731301744302,0.883971369177397,6,98970,100298,100274,1328,-24,2083
CAGTAG,3.46088449577004,0.330228220245026,1.2267257184123301,0.883719394314609,6,99978,100275,100275,297,0,2084
CCCATT,3.8105103785617502,0.203417011265195,1.21670922986195,0.8835228698472559,6,98956,100299,100276,1343,-23,2085
AATTAT,3.37872551463148,0.639080641910356,1.19831854108389,0.8835048294040279,6,100190,100358,100277,168,-81,2086
TGGTAC,3.13648957063963,0.39583093064541996,1.2355215330842602,0.8831858669839029,6,100762,100246,100278,-516,32,2087
AGTAGT,2.9926247742702503,0.41261430897108703,1.22753190390163,0.8825311804443521,6,101007,100270,100279,-737,9,2088
CAAGGG,3.85426496357261,0.46899473038302203,1.22401453525781,0.882014118698284,6,98760,100281,100280,1521,-1,2089
GTCACT,3.4572134445977794,0.385074897482038,1.22421296115716,0.88183971424913,6,99991,100280,100281,289,1,2090
ATCACC,3.57223377767489,0.49137063921906704,1.2210560911131,0.8818319882939408,6,99675,100289,100282,614,-7,2091
CCTATA,2.9518633833827597,0.0435406878944757,1.22782171551895,0.8817870121204899,6,101052,100269,100283,-783,14,2092
CTCATT,3.7347200449228,0.42950365619354397,1.20608726641951,0.8817330334793609,6,99233,100334,100284,1101,-50,2093
GGTGAT,3.56929159565963,0.531758268222887,1.22068416225677,0.8816900975226339,6,99686,100290,100285,604,-5,2094
AATGAG,3.7317656467494,0.442132815526263,1.2058360054177,0.8814824858936959,6,99242,100336,100286,1094,-50,2095
GATCTG,3.45788871081313,0.25519392215565,1.22312986852581,0.8811188954005841,6,99989,100284,100287,295,3,2096
GGCTTT,3.77483644697474,0.286779614598075,1.2141166457192099,0.88107195811433,6,99093,100302,100288,1209,-14,2097
TACTGG,3.3847617151788096,0.120280344978829,1.22473548777019,0.880751850637058,6,100172,100279,100289,107,10,2098
GTAGGT,3.10236918079498,0.436613915008191,1.23221503164212,0.8801278988915581,6,100820,100255,100290,-565,35,2099
GGGCCG,3.08911969569336,0.7358579855079681,1.27144670312107,0.8800592948119399,6,100845,100112,100291,-733,179,2100
AAGACT,3.54033743048999,0.36778218546441704,1.2089176411501201,0.880023366379614,6,99763,100319,100292,556,-27,2101
ACCTAC,3.10406445790759,0.428243310348581,1.2321464266033,0.879915793000973,6,100814,100256,100293,-558,37,2102
ACTAGG,3.0633753137374002,0.023077191233698,1.23313520207901,0.8798286673915021,6,100897,100253,100294,-644,41,2103
GGGGAT,3.61010634534004,0.4097867508366311,1.22716555904993,0.879242764553515,6,99597,100272,100295,675,23,2104
AGTGAC,3.45255369610017,0.6166423277784201,1.21918016084322,0.8781112324145649,6,100001,100294,100296,293,2,2105
CCTAGT,3.0599015795586,0.0181627332239422,1.23079863291055,0.87809106809688,6,100902,100258,100297,-644,39,2106
CCCTTG,3.84521740762667,0.45300621060447105,1.21804768034004,0.8775405474201469,6,98801,100297,100298,1496,1,2107
GAATTG,3.33131187480549,0.377758696749879,1.21038935236462,0.877080291694066,6,100301,100314,100299,13,-15,2108
AGGACT,3.58370566999698,0.234782508428131,1.21389757706452,0.8769854773369399,6,99651,100304,100300,653,-4,2109
AGGATT,3.53881494885213,0.225506696005105,1.2046217646415,0.876957747381871,6,99765,100338,100301,573,-37,2110
AAGACC,3.6097891621024703,0.37206554688038,1.21320100256608,0.8769136688210359,6,99599,100308,100302,709,-6,2111
CTACAA,3.37228376357826,0.40352117944520705,1.20780962619923,0.8758847285800329,6,100203,100330,100303,127,-27,2112
ATCCTT,3.4868727571888596,0.27121614665286103,1.20406740376925,0.8755118457416491,6,99922,100342,100304,420,-38,2113
AGTCTT,3.5350458130519,0.34839620719249004,1.20241421606527,0.87528430908454,6,99778,100348,100305,570,-43,2114
AGCAAC,3.45055047272699,0.5550837271465721,1.21493060733502,0.874911961673631,6,100011,100301,100306,290,5,2115
GGTCTT,3.6062452642218594,0.355909505106945,1.20992751397973,0.8746723082079929,6,99608,100316,100307,708,-9,2116
AACATG,3.7535029028964297,0.607802026238943,1.19597413106147,0.8746388985138349,6,99165,100366,100308,1201,-58,2117
GGACCT,3.4905158117348796,0.122193234600642,1.22396721750776,0.8742861926316949,6,99908,100282,100309,374,27,2118
CTACTG,3.44586698275518,0.33188364623858196,1.21365174141531,0.873998891008043,6,100020,100306,100310,286,4,2119
CGGCCC,3.08069278646666,-0.25263340526451605,1.2630197938943701,0.8738938634854669,6,100862,100150,100311,-712,161,2120
TTTGAT,3.44103876674452,0.4604568645763811,1.19289068923608,0.8737983798919841,6,100035,100377,100312,342,-65,2121
TATGGC,3.21304060120436,0.24290457996079198,1.2199912665991202,0.8737219732311279,6,100608,100292,100313,-316,21,2122
CAATTC,3.32750785988307,0.381095497023736,1.20590059453119,0.8736649123953891,6,100311,100335,100314,24,-21,2123
GTAGAA,3.3686346248261803,0.369450688537201,1.20446328156432,0.8734738099268101,6,100209,100341,100315,132,-26,2124
CATGTT,3.7532245469127594,0.6059085693016041,1.1940806741241299,0.8733427970368219,6,99166,100371,100316,1205,-55,2125
TTCACC,3.79671100314233,0.5106527748955471,1.20290985444253,0.8732325121600899,6,99006,100346,100317,1340,-29,2126
AAATCC,3.48168155896986,0.0978500363656867,1.20049130650392,0.872713187091085,6,99928,100354,100318,426,-36,2127
AGTCCT,3.5764019618628997,0.22908491763094396,1.2081554561544399,0.8726949024353449,6,99667,100326,100319,659,-7,2128
GCTATG,3.2115498305507497,0.29388702918961795,1.21850049594551,0.872621498280578,6,100612,100296,100320,-316,24,2129
TGTTGA,3.5611826062419905,0.576740653709281,1.19763662166311,0.8723494109227221,6,99711,100360,100321,649,-39,2130
CAATTA,3.05072099983846,0.361242730819887,1.20102016604192,0.8721760951908921,6,100918,100353,100322,-565,-31,2131
GACCCT,3.64933718126531,0.45047754231785,1.21551901205342,0.8715866295599041,6,99501,100300,100323,799,23,2132
TAGGAT,3.0912467199548597,0.27341305429977997,1.20945886340608,0.87156585670173,6,100839,100317,100324,-522,7,2133
TAATTG,3.04749186611245,0.35925842489179,1.20003736245092,0.871491556780564,6,100922,100356,100325,-566,-31,2134
TTGTAA,3.32026596987736,0.373449249023841,1.19286782925442,0.871485220316569,6,100330,100378,100326,48,-52,2135
CCTAAC,3.0523723206769597,0.10359805127800599,1.22180828599465,0.871410663591581,6,100915,100287,100327,-628,40,2136
CATTCC,3.7942038120937096,0.506618675492643,1.20040266339391,0.8713627968052259,6,99018,100355,100328,1337,-27,2137
GGATAT,3.24470170725015,0.362636054987981,1.20484373899247,0.871338913362949,6,100500,100337,100329,-163,-8,2138
AGGGTC,3.64691479374898,0.45880403599314207,1.2138238408679298,0.870413337937115,6,99510,100305,100330,795,25,2139
TTGTCC,3.43839885379746,0.377405574591563,1.2086023333025,0.8702602919363721,6,100041,100320,100331,279,11,2140
ATATTG,3.19940726063115,0.351674961256224,1.1938826452607199,0.8699412544469219,6,100641,100372,100332,-269,-40,2141
AAGGCC,3.83220054124789,0.422724084743319,1.20792747074951,0.869925186578395,6,98850,100327,100333,1477,6,2142
AAGGCT,3.75840827758344,0.310179959817635,1.19930357728158,0.869902620068544,6,99145,100357,100334,1212,-23,2143
TAGTGC,2.94215785796669,-0.0495126520403559,1.22282829456108,0.8698745460517501,6,101072,100285,100335,-787,50,2144
AAGTCC,3.4364132227640294,0.323557702562779,1.20823180322275,0.8698500420484921,6,100048,100324,100336,276,12,2145
AATTCT,3.64123339865388,0.35130937767966197,1.18258805424645,0.869795754697706,6,99526,100412,100337,886,-75,2146
GTTGCT,3.43863329948843,0.383101341340099,1.20787914618282,0.869789113161755,6,100039,100329,100338,290,9,2147
TATTAA,3.2060656863330697,0.354787084237943,1.18372882449437,0.8696612531362109,6,100625,100405,100339,-220,-66,2148
CAATAT,3.20039631605244,0.350417686542514,1.19262537054701,0.8689540965268001,6,100637,100381,100340,-256,-41,2149
GCCATA,3.2088765416504,0.254781225041432,1.21358087691015,0.868941696294715,6,100615,100307,100341,-308,34,2150
AGAATT,3.64100504661871,0.34618881526707,1.18120140829419,0.868766023003899,6,99528,100415,100342,887,-73,2151
TAATCA,3.04573249209671,0.334647571924524,1.1960316583001698,0.8684565146063459,6,100926,100365,100343,-561,-22,2152
TTAATA,3.20440148737342,0.35104482058108694,1.18206462553472,0.868408337809886,6,100629,100413,100344,-216,-69,2153
CATAGC,3.20790356381945,0.279142911662939,1.2126078990792,0.868224599439999,6,100618,100311,100345,-307,34,2154
TTCTAT,3.4038176148221804,0.3549019550322971,1.1861806315990802,0.868156840212812,6,100133,100398,100346,265,-52,2155
TAAGAC,2.9744806602760696,0.151128512492082,1.2079267018731898,0.867962146390197,6,101025,100328,100347,-697,19,2156
GTCTTA,2.97143227938457,0.436560704620877,1.20749770293303,0.8676949786763409,6,101029,100331,100348,-698,17,2157
TGGTCC,3.5099726392234,0.11925939150577802,1.21405011572128,0.8676738922224181,6,99856,100303,100349,447,46,2158
TGTACA,3.35519661289976,0.341696158474139,1.19674631395804,0.867619930640143,6,100252,100363,100350,111,-13,2159
AGTGAA,3.71297847198452,0.5845109975880319,1.18704883065283,0.8673983976937941,6,99302,100395,100351,1093,-44,2160
GCACTA,2.93985058287166,0.326623291884268,1.2194329832481299,0.86730412465484,6,101075,100293,100352,-782,59,2161
ATCAAA,3.43311022184079,0.46018129019556797,1.18433091515101,0.867203529275035,6,100057,100402,100353,345,-49,2162
AAGGAT,3.4735687308211602,0.583271883670706,1.1927024013791399,0.866979598297855,6,99946,100380,100354,434,-26,2163
AGTTTA,3.24900420177052,0.26143616157416,1.18827903633923,0.8667955750943149,6,100490,100392,100355,-98,-37,2164
AGATAC,3.1266006165336298,0.582306531318729,1.20197654642185,0.866795489750994,6,100785,100350,100356,-435,6,2165
GCTAGC,3.05688817840199,0.0313681719595742,1.2269934779982201,0.8667811548845419,6,100908,100274,100357,-634,83,2166
GGACAA,3.43312124113685,0.36952749602817997,1.20380265658523,0.8665875748595991,6,100056,100343,100358,287,15,2167
GGGATA,3.20719359639139,0.17477240556725,1.21000783277216,0.866442322458323,6,100622,100315,100359,-307,44,2168
GACCCA,3.67385354604217,0.19398573381317702,1.20727795240993,0.8661368299739591,6,99430,100333,100360,903,27,2169
TAGTCA,3.00115749919535,0.23949383985207398,1.20446549832347,0.86607716454541,6,100995,100340,100361,-655,21,2170
CACAAT,3.50926606757545,0.435506375680165,1.19049932678982,0.86597914027624,6,99862,100386,100362,524,-24,2171
GTACCA,3.11514764124482,0.37216850175171795,1.21193327355444,0.865766566772945,6,100798,100312,100363,-486,51,2172
TGCATA,3.3520691670355696,0.5595614667945179,1.1936188680938502,0.865291604390001,6,100260,100373,100364,113,-9,2173
GGACTT,3.4326025622578102,0.303813296838724,1.20166887675252,0.8651436937686701,6,100059,100351,100365,292,14,2174
TAAGAG,3.2924581133000697,0.143884933287561,1.1949597452298601,0.8650854466878359,6,100392,100369,100366,-23,-3,2175
ATTGTG,3.50339414924557,0.42041858912669605,1.1891200687299601,0.865044113411422,6,99876,100390,100367,514,-23,2176
CTCACG,2.9484117655293702,1.05248348195823,1.2279941659058402,0.8649309832666651,6,101059,100266,100368,-793,102,2177
AGCTTT,3.68105379913298,0.38659682614978796,1.18402015113296,0.864643306401663,6,99408,100404,100369,996,-35,2178
TATAGG,2.9282106142277096,0.0256988835448979,1.20449286938782,0.8646340830760391,6,101088,100339,100370,-749,31,2179
CTCTTA,3.2895713678326803,0.35708063376083893,1.19438958759665,0.8646278074091479,6,100402,100370,100371,-32,1,2180
TGATTA,3.03774846030323,0.350516521419662,1.1902939566417,0.8642273280773259,6,100944,100387,100372,-557,-15,2181
CGTGAG,2.94566972697038,-0.304439781876249,1.2263401635647702,0.8638057382469359,6,101064,100276,100373,-788,97,2182
TGGGTC,3.66546113938021,0.19571137428780702,1.2030173861309,0.8631030592925699,6,99455,100345,100374,890,29,2183
TATGCA,3.3489842779194903,0.47641218033356303,1.19053397897777,0.86299525582839,6,100272,100385,100375,113,-10,2184
TTGCAA,3.5121758969048305,0.5439858096930159,1.18617409241353,0.8629782577066579,6,99849,100399,100376,550,-23,2185
ATCCTA,3.0799933773022996,0.446736433763418,1.19788159772959,0.8629057381574279,6,100864,100359,100377,-505,18,2186
ATCTTG,3.4703771824053105,0.45958519373400897,1.18661419617504,0.862546698173551,6,99953,100397,100378,444,-19,2187
GTGTAG,3.07835023517501,0.0641966414942186,1.20819608602215,0.862456408938452,6,100869,100325,100379,-544,54,2188
AGCCTT,3.75084572108423,0.39719254909228296,1.18864370288769,0.862029139718158,6,99177,100391,100380,1214,-11,2189
TATCCC,3.1992444082977998,0.165499480141454,1.20329630887865,0.86138251960649,6,100642,100344,100381,-298,37,2190
TTACAC,3.0329564829490097,0.0551473690106779,1.1966533603665601,0.8610636740199371,6,100948,100364,100382,-584,18,2191
ATCTTA,3.0036502963849596,0.46877872162127004,1.18670688700877,0.860920408485256,6,100990,100396,100383,-594,-13,2192
GGGCTA,3.2402017134334202,0.303624870078641,1.21281902594093,0.8609192076788009,6,100512,100309,100384,-203,75,2193
GCAATG,3.5836450290218598,0.5796311366315821,1.19151722152339,0.860815246944275,6,99652,100384,100385,732,1,2194
AACTGC,3.55381280032808,0.11070352110575699,1.19219608711495,0.86066624615837,6,99724,100383,100386,659,3,2195
TACCAG,3.35868574476084,0.0911366212440949,1.1971773004111999,0.860301372478116,6,100239,100361,100387,122,26,2196
CAAGAT,3.4705390567598395,0.589439297125153,1.1833714464774798,0.860096486028009,6,99952,100408,100388,456,-20,2197
CATTCA,3.7372357695200495,0.588409417756397,1.17584556659641,0.859624394870131,6,99221,100422,100389,1201,-33,2198
CTGGTA,3.3558609989342005,0.09137962873421301,1.1958347715255802,0.8593767074794979,6,100250,100367,100390,117,23,2199
GGACCA,3.5019558365161,0.10424162355491999,1.2026498178686298,0.859249386369638,6,99882,100347,100391,465,44,2200
AGGCGG,3.67341733031226,0.137633264095996,1.20856786633395,0.859040660601583,6,99432,100321,100392,889,71,2201
TAAGGT,2.96062810993778,0.279863386825662,1.1955352395691599,0.8588705046981059,6,101038,100368,100393,-670,25,2202
TACTCA,3.3129240430171003,0.40840122813475,1.18498483836072,0.8582272606302109,6,100344,100400,100394,56,-6,2203
AATCCT,3.5094361100357996,0.200507369396439,1.17957790791993,0.8580858072604971,6,99860,100417,100395,557,-22,2204
CCGCCT,3.67134683684593,0.13659010495374,1.20733174376079,0.8580250998248791,6,99438,100332,100396,894,64,2205
GTAGGA,3.23570239309801,0.218026435313659,1.19714150395005,0.8578239570242091,6,100525,100362,100397,-163,35,2206
CTACAC,3.0739997715538903,0.0605757488937275,1.2020817402496,0.8578045248501129,6,100878,100349,100398,-529,49,2207
TGACTA,2.98892219287394,0.44004757530722,1.19301543410281,0.8575936544172791,6,101014,100376,100399,-638,23,2208
TAGCCC,3.23596788546508,-0.0366713902804623,1.2082612749486699,0.8574919526588499,6,100524,100323,100400,-201,77,2209
ACCTTA,2.95894264590139,0.389643865160878,1.1935469814156001,0.8573176863574591,6,101042,100374,100401,-668,27,2210
TGCTTA,3.3092859795976697,0.536101122270244,1.18359310507629,0.857240078128193,6,100355,100406,100402,51,-4,2211
TTCACT,3.70182817486609,0.5695826816050881,1.17319539636281,0.8570810585640221,6,99347,100429,100403,1082,-26,2212
CACATC,3.61746474332913,0.429868731587401,1.1848616826970602,0.8565876702390991,6,99582,100401,100404,819,3,2213
TAAGCA,3.3117051824087405,0.21430194552593698,1.1826076838352801,0.856475788429583,6,100348,100411,100405,63,-6,2214
TCAACA,3.5387247747265698,0.54494085262785,1.17610914819036,0.856068121674513,6,99766,100421,100406,655,-15,2215
CAGGTC,3.65814685911753,0.12283896656553,1.19345677573322,0.855993884756784,6,99474,100375,100407,901,32,2216
TAAACT,3.23180179171096,0.24143934499337,1.17385002115043,0.855861588264509,6,100541,100425,100408,-116,-17,2217
TAAGAT,2.9978252831951,0.307693854245974,1.1797235799018202,0.855736171491756,6,100997,100416,100409,-581,-7,2218
GACCTG,3.6568275977124705,0.122483037876821,1.19249833421524,0.855280730209293,6,99476,100382,100410,906,28,2219
TCCTAC,3.23008637314802,0.21371373858339202,1.19278427710688,0.85449996121435,6,100546,100379,100411,-167,32,2220
CTTAGT,2.95313111500216,0.150925580382655,1.18919653855063,0.854169950156765,6,101051,100389,100412,-662,23,2221
CACGTG,2.96268982767083,-0.193162654084173,1.21176113376196,0.8538753186263379,6,101035,100313,100413,-722,100,2222
ACTAAG,2.95482002931112,0.157378454895525,1.18826607090825,0.853432505637867,6,101045,100393,100414,-652,21,2223
AATCTG,3.5327797514554304,0.204474508684065,1.17241045505422,0.853353300543239,6,99787,100431,100415,644,-16,2224
AAAGTC,3.50332887958283,0.42175793117666105,1.1723123835498799,0.852679356381679,6,99877,100432,100416,555,-16,2225
GATGAA,3.53278045968848,0.586686381711724,1.17084957606326,0.8522114638675079,6,99786,100435,100417,649,-18,2226
CAGATT,3.5359556693758303,0.18634776486145002,1.1701633546619399,0.851776855093188,6,99775,100437,100418,662,-19,2227
AACTGG,3.7325145263782797,0.0689546832850585,1.1734098260764199,0.8506233521295379,6,99238,100427,100419,1189,-8,2228
GTTACT,2.94823009776269,0.4456095688326961,1.18429552131116,0.850549509657695,6,101060,100403,100420,-657,17,2229
AATGAC,3.36688172336711,0.631097472502582,1.1718964917027401,0.849779855531525,6,100214,100433,100421,219,-12,2230
ATCATT,3.4107809359554304,0.487434073565488,1.16038652831199,0.8493582005356299,6,100114,100474,100422,360,-52,2231
TAGTAA,2.8999808927535997,0.3834686365256671,1.17327632597757,0.84917238129915,6,101117,100428,100423,-689,-5,2232
GCAATA,3.1028452694906803,0.346517233892646,1.17753703884628,0.848699682119818,6,100818,100418,100424,-400,6,2233
TGTATC,3.1375070555254196,0.489649927687019,1.1762162320174498,0.8485344616302242,6,100760,100420,100425,-340,5,2234
CATTGC,3.56966215324849,0.5703960890855501,1.17367291466134,0.8476555470947289,6,99684,100426,100426,742,0,2235
ATTGGT,3.1275225323274904,0.33531614744288,1.17500674988172,0.847508750329358,6,100782,100424,100427,-358,3,2236
CAGGTT,3.7613767489282797,0.0972817140847084,1.1678995232523999,0.847228183481389,6,99132,100443,100428,1311,-15,2237
TTCATC,3.52815072727673,0.576483850946824,1.1639199997868401,0.8470924080744471,6,99798,100459,100429,661,-30,2238
AATACT,3.22004315158561,0.33107157607145,1.1620913810250901,0.8470707174174659,6,100580,100466,100430,-114,-36,2239
TATGAT,3.0146875714047097,0.42135429753750303,1.16723306774318,0.847045328602665,6,100974,100447,100431,-527,-16,2240
TGCATT,3.7180248866958303,0.524823612607872,1.1588810139071999,0.8469587846579159,6,99280,100481,100432,1201,-49,2241
TCTTAT,3.21484854363729,0.307595602554812,1.1616136114275901,0.8467193687948491,6,100601,100469,100433,-132,-36,2242
GTCATT,3.36463105767318,0.441284195283233,1.16724548295439,0.8464604852318691,6,100219,100446,100434,227,-12,2243
CACTTA,3.29707463394096,0.557088948539914,1.1691354292845801,0.846441874427916,6,100384,100439,100435,55,-4,2244
AAAGCT,3.65518241631496,0.36888082698176006,1.1597638692686,0.8463637190878279,6,99484,100475,100436,991,-39,2245
ATAAGA,3.2143352897127597,0.32001841554703103,1.16115387123273,0.846276279492809,6,100603,100470,100437,-133,-33,2246
ACCAAT,3.12933501479904,0.333347042381284,1.17311181418401,0.845989903055193,6,100777,100430,100438,-347,8,2247
TAAGGC,3.1463568834836,0.111725747008659,1.1826603492466201,0.845551727270703,6,100741,100410,100439,-331,29,2248
GTGTAA,3.0067768276017897,0.0310115375135851,1.17501098204152,0.8450549961647809,6,100987,100423,100440,-564,17,2249
AATGTG,3.7116632495595803,0.38767932825636103,1.1563808078596298,0.8450106520452249,6,99307,100486,100441,1179,-45,2250
GGAATG,3.75451658863908,0.45741260116801596,1.1649007940518898,0.8449162075747009,6,99160,100456,100442,1296,-14,2251
TAAGTG,3.29342835156339,0.25131496600187303,1.1665771831249299,0.844604733657737,6,100390,100450,100443,60,-7,2252
CACACT,3.76114642559149,0.409148362836367,1.16414131394603,0.844365930192703,6,99133,100458,100444,1325,-14,2253
GATACA,3.13560909837025,0.391568342181534,1.17051035750327,0.8442812191467901,6,100763,100436,100445,-327,9,2254
AATCTA,3.05597313805916,0.41365334113142893,1.1624234185120301,0.8442465214332131,6,100912,100464,100446,-448,-18,2255
TGAGTA,3.29265474263936,0.40210038430945794,1.1658035742008999,0.8440301779334208,6,100391,100452,100447,61,-5,2256
AATCAG,3.4916989998767205,0.260484069140828,1.16068250384377,0.8440022975378481,6,99902,100471,100448,569,-23,2257
TTACTA,2.89596911821284,0.47087153627461104,1.16618836244888,0.843971236125298,6,101121,100451,100449,-670,-2,2258
TGCAAT,3.47714017805658,0.526562366106633,1.16061976740596,0.843731494174052,6,99938,100472,100450,534,-22,2259
AGTATT,3.21796508680262,0.328298181114903,1.15723992137133,0.8435829475096591,6,100591,100484,100451,-107,-33,2260
AGGTCC,3.44781638606105,0.0921043177716978,1.1812466629271798,0.8428777857482851,6,100014,100414,100452,400,38,2261
AATGAT,3.39833131045654,0.644188976537182,1.1517983339017699,0.8428434010777309,6,100146,100498,100453,352,-45,2262
AGTGTG,3.75551401650577,0.319663939942618,1.16184327121323,0.8427658482933471,6,99156,100467,100454,1311,-13,2263
GCCCTA,3.2157369009124,0.271938259127349,1.18803029039599,0.8426964144123399,6,100599,100394,100455,-205,61,2264
CCAGTT,3.72481354419079,0.0565708468271335,1.16261152599424,0.842653761452259,6,99266,100463,100456,1197,-7,2265
TATTGC,3.0959991207357698,0.340134048881279,1.16907578913771,0.8425647933556579,6,100832,100440,100457,-392,17,2266
TAGATT,3.05604180051544,0.390523725240305,1.15931539279063,0.842079693099708,6,100911,100477,100458,-434,-19,2267
ATCATA,3.01024920245863,0.5448532775808971,1.16054836866209,0.842020931809125,6,100983,100473,100459,-510,-14,2268
TTCTAC,3.3277766083031,0.330408693403616,1.1616873699703998,0.8416855818639009,6,100310,100468,100460,158,-8,2269
CACATT,3.7129880086679306,0.396604854634635,1.1515978057443,0.8414592656397142,6,99301,100499,100461,1198,-38,2270
GCATTG,3.32280779695513,0.326021106235036,1.171688350641,0.8413581641704742,6,100326,100434,100462,108,28,2271
GTAAGT,3.00161343190064,0.46978783721356304,1.1698475863403701,0.841238154218009,6,100992,100438,100463,-554,25,2272
CCTACA,3.3618846220657796,0.10266534735563199,1.16877704721288,0.839913920387951,6,100227,100441,100464,214,23,2273
TAGGGC,3.2106741294858,0.00910252661129718,1.18329144199331,0.839321395593982,6,100614,100409,100465,-205,56,2274
AGATAA,3.3647921036688597,0.55367977813002,1.14761192748234,0.8391337733337679,6,100218,100515,100466,297,-49,2275
AGCATT,3.6789493633848305,0.489311410776011,1.14915829096446,0.839101065929794,6,99415,100508,100467,1093,-41,2276
GTACCT,3.04692107382284,0.35577852268923,1.1764641305528,0.839055803538432,6,100924,100419,100468,-505,49,2277
TGCACC,3.82513915629046,0.47295492503650605,1.16521200458349,0.83902875815036,6,98890,100454,100469,1564,15,2278
CATGAT,3.47076248752319,0.56606997205005,1.15424207687258,0.838975918615265,6,99951,100489,100470,538,-19,2279
AGCCTA,3.32886737614592,0.37590777800087805,1.16735893179628,0.8382761382916128,6,100307,100445,100471,138,26,2280
TGAATG,3.70223886653775,0.56279323048626,1.1469564248378001,0.837954265565075,6,99345,100519,100472,1174,-47,2281
GTTGTG,3.42470597718714,0.39473924999292703,1.16344072959619,0.837558010487729,6,100075,100461,100473,386,12,2282
CTCAAC,3.39875722214519,0.38771204044434293,1.1642956506703102,0.8374272130379989,6,100145,100457,100474,312,17,2283
CTGATT,3.4844803630792405,0.261954304944151,1.1514454727857,0.83724529124373,6,99924,100500,100475,576,-25,2284
TTACAA,3.2753803831952597,0.34223270778403697,1.14652115453806,0.83672792297693,6,100430,100523,100476,93,-47,2285
GGTATA,2.8903355929168795,0.17102735539577,1.16661784807699,0.8366805607446541,6,101128,100449,100477,-679,28,2286
AAGGGT,3.39095419250799,0.37635696357391707,1.16309669599063,0.8365421352455831,6,100161,100462,100478,301,16,2287
AGTTTG,3.67316895992415,0.413190392979088,1.14562421763879,0.836501468606806,6,99433,100527,100479,1094,-48,2288
TATACC,2.8897005739313597,0.17006841338632503,1.16565890606755,0.83589218264249,6,101129,100453,100480,-676,27,2289
CAACTA,2.9617683999539195,0.44431615985983797,1.16361531104778,0.835823838490994,6,101036,100460,100481,-576,21,2290
TGCAAG,3.74827513048885,0.51830065376198,1.1523580550613102,0.8356599917785409,6,99184,100495,100482,1311,-13,2291
AGCATG,3.74817224983033,0.492408294214332,1.15225517440278,0.835583736413108,6,99185,100496,100483,1311,-13,2292
AACTTC,3.47925798328532,0.32000002966588204,1.14939978116945,0.835573145749245,6,99934,100506,100484,572,-22,2293
CATGCT,3.7469915576760697,0.504740793359561,1.1522327761656102,0.8355501214014409,6,99191,100497,100485,1306,-12,2294
AGTAGG,3.3235845704938503,0.28485369059353305,1.1624000491681399,0.834697282392748,6,100325,100465,100486,140,21,2295
GGTGCA,3.8188306903009903,0.470301567584057,1.1592274616179399,0.834683559079995,6,98914,100479,100487,1565,8,2296
TGTAAG,3.27997099449385,0.268087101930659,1.1531198260553899,0.8346054521065749,6,100419,100491,100488,72,-3,2297
TAAATC,3.04223054299253,0.21627014728833605,1.1486808234453998,0.834008786665637,6,100934,100510,100489,-424,-21,2298
ACCCTT,3.39087758447054,0.267539378735407,1.1596199759413301,0.8339582357651651,6,100162,100476,100490,314,14,2299
ATCATG,3.4635969999502905,0.5589044844771469,1.14707658929967,0.8336351019487579,6,99970,100518,100491,548,-27,2300
TTATCT,3.3576882778879704,0.539227964648735,1.14005129466487,0.8335734639193609,6,100241,100535,100492,294,-43,2301
AGGTAC,3.04035969437077,0.35747153972717205,1.1687444571836498,0.833407460375112,6,100937,100442,100493,-495,51,2302
AACCTG,3.73926033653532,0.0793053225857818,1.1493206189242,0.833245665605907,6,99218,100507,100494,1289,-13,2303
ATTGCA,3.4628028485993703,0.506289205034127,1.14628243794875,0.833043399664287,6,99974,100524,100495,550,-29,2304
GATCCT,3.36314767456418,0.17982938803871,1.1588999265622,0.832934969702873,6,100222,100480,100496,258,16,2305
ACTTAC,2.9945043175231003,0.46241906987614795,1.1582011949406399,0.8326350742284079,6,101002,100483,100497,-519,14,2306
AAGTTG,3.3422605997324903,0.38238464240257897,1.1487364561023798,0.8326116781631279,6,100286,100509,100498,223,-11,2307
GCCTTA,3.1275697937946405,0.0942899146676961,1.16503155347474,0.832567632555521,6,100780,100455,100499,-325,44,2308
CATGCA,3.77497568132784,0.513402074097703,1.14745947539703,0.8325667986447329,6,99092,100516,100500,1424,-16,2309
AATCCA,3.5072020833546,0.32805824135637895,1.14458645681838,0.832543364897789,6,99864,100529,100501,665,-28,2310
TGTAGG,3.34900643382475,0.0942659931734617,1.15846911213079,0.8324321760389949,6,100271,100482,100502,211,20,2311
CACTCA,3.7451049505003198,0.37151622862888595,1.14809983885485,0.8324288843155558,6,99199,100513,100503,1314,-10,2312
CCTACT,3.31966144787342,0.27635535893538005,1.1593112974408701,0.8323189271267919,6,100332,100478,100504,146,26,2313
TCATAG,3.24086195729339,0.32603136863066806,1.15085382244478,0.8321778528461701,6,100507,100503,100505,-4,2,2314
TGCATG,3.7719551268389497,0.512627849743822,1.1466852510431498,0.8320370367547031,6,99100,100522,100506,1422,-16,2315
CTAGGA,3.5224403420929598,0.173517180524112,1.1526322491605,0.831540237825256,6,99818,100494,100507,676,13,2316
CAACTT,3.3459437652206403,0.386738681591202,1.1470971024675902,0.831409001660019,6,100281,100517,100508,236,-9,2317
GATCCA,3.39199346767015,0.33846007978581705,1.15498829524782,0.8306432809160229,6,100159,100488,100509,329,21,2318
GACTCT,3.52006938009565,0.31411062724446603,1.1514195810802699,0.8306262730931949,6,99825,100501,100510,676,9,2319
AGAGTC,3.5206335402850497,0.310633344428611,1.15122874065951,0.83049297944205,6,99822,100502,100511,680,9,2320
CAATGC,3.30986894198407,0.325218814667984,1.1565031655349298,0.8301015682952679,6,100353,100485,100512,132,27,2321
TTGATA,3.0397922566351,0.429196316664616,1.14306584891029,0.82997449911797,6,100938,100531,100513,-407,-18,2322
CCTGAT,3.49957525464445,0.0806286018792513,1.1506438982176699,0.8296696138064781,6,99889,100504,100514,615,10,2323
CAAACT,3.66240451727099,0.42550490044329303,1.1353868397213702,0.8286639098274841,6,99467,100552,100515,1085,-37,2324
GATTTA,3.03784587871539,0.21427659622551198,1.14111947099058,0.828525495707697,6,100943,100533,100516,-410,-17,2325
GACTTT,3.4723183921108403,0.37372895696034,1.1392835018173,0.828178559910236,6,99950,100536,100517,586,-19,2326
TGGATT,3.50200864320258,0.29597943740087895,1.1384626586236901,0.8281676055898459,6,99881,100542,100518,661,-24,2327
TAGGCT,3.31302390953592,-0.135204408229884,1.1529976821273,0.8277428197323059,6,100343,100493,100519,150,26,2328
TGATAT,3.14240728309831,0.29467498372338397,1.1368826677278798,0.827370362987701,6,100748,100549,100520,-199,-29,2329
AATGCA,3.69012444897211,0.498538275837822,1.13259567713715,0.827162141590461,6,99386,100557,100521,1171,-36,2330
TCCTAG,3.51495262292349,0.16763557869154,1.1467061172150301,0.8271265508861401,6,99839,100521,100522,682,1,2331
ATCAGG,3.49757042025062,0.0760988475450564,1.14671665671275,0.8267925663187191,6,99894,100520,100523,626,3,2332
TGGATC,3.38343241877157,0.306190355261437,1.14867357648425,0.826026427319607,6,100177,100511,100524,334,13,2333
GTCATC,3.2216269496449703,0.485098322339319,1.15302851721775,0.8258933168422429,6,100575,100492,100525,-83,33,2334
AGGTAA,3.30463356602355,0.344861106127764,1.1404622227617,0.825860922236753,6,100367,100534,100526,167,-8,2335
CTTAAC,2.9156952318074705,0.20645427412366896,1.1502995673216798,0.8253955412756999,6,101101,100505,100527,-596,22,2336
GCCACG,2.7772513091819704,0.7116598153141891,1.1894772494745802,0.8248962793304929,6,101209,100388,100528,-821,140,2337
AGTTCT,3.6275568777435,0.299244553176687,1.13052322974347,0.8246198808780241,6,99550,100561,100529,1011,-32,2338
ATATCA,3.14101618803191,0.291037558521984,1.13324524252648,0.82461153257662,6,100751,100556,100530,-195,-26,2339
AGAACT,3.6258844798594505,0.295453339785972,1.1304659328130902,0.8244578850821801,6,99558,100562,100531,1004,-31,2340
AACAGG,3.7292130818318703,0.0667331479419655,1.1373509571096598,0.8243748983276591,6,99254,100546,100532,1292,-14,2341
TGAGTG,3.73071085142604,0.37333691624206394,1.1370401061335,0.8243130250944319,6,99251,100547,100533,1296,-14,2342
GATGAT,3.25966773804085,0.624766061349202,1.13874521559998,0.823819032271792,6,100463,100539,100534,76,-5,2343
CTTACA,3.26631334006295,0.246627377067952,1.1383741354065702,0.8235927732682141,6,100445,100543,100535,98,-8,2344
TTACCT,3.3025972722877097,0.332604917700294,1.13650803395501,0.8229709154256619,6,100370,100551,100536,181,-15,2345
CAGTAC,3.05687484924108,0.23487410205580897,1.1536604815507,0.822945067291351,6,100909,100490,100537,-419,47,2346
CCTGTT,3.72660522762968,0.0650351127264663,1.1350504090648799,0.822757943608305,6,99259,100553,100538,1294,-15,2347
AGAGTT,3.62604238789562,0.287255049747612,1.1278504459785101,0.822637812254664,6,99557,100571,100539,1014,-32,2348
AATTGT,3.25478445103965,0.30796773018613,1.12738631041671,0.822480411837978,6,100474,100573,100540,99,-33,2349
ATCATC,3.2585303089010798,0.52200168159543,1.1369230435492,0.82239626964248,6,100465,100548,100541,83,-7,2350
ACAATT,3.25530604067965,0.32215836526843394,1.12644681202246,0.8217195097579449,6,100471,100576,100542,105,-34,2351
AATGCT,3.65011241191261,0.477849081691954,1.12534106449801,0.821197417925593,6,99495,100579,100543,1084,-36,2352
AGGATC,3.34791501916578,0.163393908610322,1.1425089772467198,0.820849729440461,6,100278,100532,100544,254,12,2353
GATGAC,3.21529341006458,0.605119613313946,1.14591863251411,0.8206666633336899,6,100600,100526,100545,-74,19,2354
CGTGGC,2.7690178890642,-0.645429563722942,1.1834901594918201,0.8206639795187719,6,101215,100407,100546,-808,139,2355
ACTATC,2.74917818630589,0.365959249834024,1.1481845728335,0.820538526811188,6,101226,100512,100547,-714,35,2356
GTTAAG,2.90860056687469,0.21384346089327105,1.14350769650607,0.8204685258389549,6,101106,100530,100548,-576,18,2357
TATCAA,3.02388952486565,0.423098659774063,1.13033980531852,0.8203553149464878,6,100960,100563,100549,-397,-14,2358
GATAGT,2.74886115844782,0.36204342685643504,1.14776704578568,0.8203222457481291,6,101227,100514,100550,-713,36,2359
TTATAA,3.2936804736658996,0.545839177797335,1.11327350011831,0.8193791156877929,6,100389,100617,100551,228,-66,2360
GTACTT,2.9739436006694104,0.422797983780947,1.13910156612121,0.8185945780595881,6,101026,100537,100552,-489,15,2361
CAAGTA,3.26067284648583,0.5948611531275351,1.13157534791236,0.8185625693332299,6,100460,100558,100553,98,-5,2362
AAGTAC,2.97195801245278,0.438671329731443,1.1387310788582499,0.8181919548276999,6,101028,100540,100554,-488,14,2363
CAATAA,3.3675667020732303,0.42651114847904,1.11878739538346,0.818066610602101,6,100211,100601,100555,390,-46,2364
TAATAG,2.9465747864922,0.287694145639799,1.1284730831989198,0.817613256025565,6,101062,100568,100556,-494,-12,2365
CTATTA,2.94519851555251,0.288477670954279,1.12825510617632,0.8174349690429871,6,101066,100569,100557,-497,-12,2366
CTTAGG,3.2986489614783996,0.0377230122577359,1.1386227340697799,0.8171405161046841,6,100381,100541,100558,160,17,2367
CACCTA,3.3308420553563898,0.4454774009565129,1.13773448050349,0.8169981665355659,6,100304,100545,100559,241,14,2368
CCTAAG,3.2997483736732205,0.0421456608255042,1.13823992932358,0.816794644847954,6,100379,100544,100560,165,16,2369
GTACAA,2.9700426699787097,0.332527289630161,1.13681573638418,0.8167774744495592,6,101031,100550,100561,-481,11,2370
GTACTG,3.04585108373358,0.230124343097662,1.14488304617821,0.8165553893074821,6,100925,100528,100562,-397,34,2371
AACACT,3.64580726951998,0.5151768772126529,1.11878959197037,0.816256674907121,6,99513,100600,100563,1087,-37,2372
AACTCA,3.64537705264494,0.341775764869354,1.11835937509532,0.815934754329381,6,99515,100602,100564,1087,-38,2373
CACCAA,3.71800641366296,0.43356328636984603,1.1258203659168302,0.8157286693606941,6,99281,100577,100565,1296,-12,2374
TACTTG,3.25294249531142,0.503227928654281,1.12724962079004,0.8153824273439159,6,100477,100574,100566,97,-8,2375
AACAAT,3.36367825997207,0.571902311217263,1.1148989532822902,0.8151558380359709,6,100221,100611,100567,390,-44,2376
TTGGTG,3.71592825042496,0.32846356166465196,1.1246973548840902,0.815138687226427,6,99289,100581,100568,1292,-13,2377
ATTGTT,3.3611556576403396,0.371313554412781,1.1130075801319,0.8138992035146899,6,100231,100618,100569,387,-49,2378
AGAGTA,3.22327122044244,0.285177456141337,1.12577285237223,0.813706828542602,6,100569,100578,100570,9,-8,2379
TCCTAT,3.21358984681005,0.14566946735502698,1.12474000587852,0.8127899073680229,6,100605,100580,100571,-25,-9,2380
AACATT,3.59752148706582,0.563122076173011,1.10611871823804,0.8127750687747471,6,99625,100640,100572,1015,-68,2381
TACTCT,3.21908929279426,0.286598558722421,1.12390751255823,0.812291071517934,6,100583,100583,100573,0,-10,2382
GTTGAG,3.361294209792,0.335737838980801,1.12938176256931,0.811768501168759,6,100230,100565,100574,335,9,2383
GTAATA,2.84951911587435,0.291794744144685,1.12281454909832,0.8117103221230179,6,101169,100584,100575,-585,-9,2384
GGAACA,3.71203708706086,0.41268676945478,1.1201749623386499,0.811609780171333,6,99305,100593,100576,1288,-17,2385
TTCATG,3.6702779139924706,0.5229619363813199,1.11113404120385,0.8112284368522661,6,99445,100622,100577,1177,-45,2386
ATAGGA,3.2139016534942,0.143216862785181,1.12233193142157,0.8110436636769749,6,100604,100587,100578,-17,-9,2387
TGAACC,3.70905421704723,0.534951305084567,1.1191144994361102,0.810792071638727,6,99315,100598,100579,1283,-19,2388
TAGGTG,3.3192621606716504,0.0505301397270195,1.1287248389776898,0.810480940465354,6,100334,100567,100580,233,13,2389
TTGTAC,2.9627079568101204,0.308447342031343,1.12786592226193,0.810303800963227,6,101034,100570,100581,-464,11,2390
ATTGGA,3.2407502813405697,0.27734453767688205,1.1198277588996899,0.809781843557463,6,100508,100594,100582,86,-12,2391
GCAGCG,2.75559466938167,0.906127310645983,1.16782060967427,0.809418919373582,6,101222,100444,100583,-778,139,2392
CGCTGC,2.7526075243120895,-0.5803298557081109,1.1670797947397,0.808840178642327,6,101225,100448,100584,-777,136,2393
TCTTAC,3.12286065855287,0.26715546236079196,1.1211734712335701,0.80850791417203,6,100790,100592,100585,-198,-7,2394
TTATTG,3.3538503014404797,0.5464643247585159,1.10570222393205,0.808430382188639,6,100255,100641,100586,386,-55,2395
GCCTAG,3.53053069898888,0.0597840433761139,1.13052568218316,0.8083382980905122,6,99793,100560,100587,767,27,2396
TAACTA,2.76989173182615,0.353612118654496,1.11946156629847,0.807755365668872,6,101214,100597,100588,-617,-9,2397
AATCAA,3.39653206217544,0.531855929080589,1.10390386973507,0.807683550617218,6,100149,100645,100589,496,-56,2398
CTACCC,3.40016128536659,0.341827705530553,1.13328876811555,0.8076040211574699,6,100140,100555,100590,415,35,2399
AACCAG,3.6754326106608497,0.00880501425086422,1.11484569341797,0.807035240358496,6,99423,100613,100591,1190,-22,2400
ATAGAT,3.08643208668602,0.5163281223315189,1.1102602716838401,0.8069486504234621,6,100851,100629,100592,-222,-37,2401
TAGTTG,2.9184261967388396,0.295660420539985,1.12398052600196,0.8066968071013799,6,101098,100582,100593,-516,11,2402
CTATTC,3.2050417571965997,0.39057263269399395,1.1161919162650702,0.8064537696370451,6,100627,100607,100594,-20,-13,2403
CTAGGC,3.5277182850229902,0.0567786659793139,1.1277132682172701,0.806271939723603,6,99801,100572,100595,771,23,2404
AGCACC,3.75227749077447,0.4294460598887629,1.12170313943574,0.806257576037875,6,99174,100591,100596,1417,5,2405
GAATAG,3.2072842919226896,0.3988959275804099,1.1157145698500601,0.806139242527863,6,100621,100608,100597,-13,-11,2406
TGTTCC,3.7037010347811603,0.418362228315104,1.1121462162163702,0.805737018753123,6,99340,100619,100598,1279,-21,2407
CAGCCG,2.9408201687808595,0.8571544030071541,1.1552341989608201,0.804954311150264,6,101074,100487,100599,-587,112,2408
AAGGTG,3.70065903176488,0.422117343143796,1.11104323717768,0.80487143962937,6,99350,100625,100600,1275,-25,2409
GGATTC,3.27578663877958,0.15979009413059803,1.1220923506754599,0.804833657535359,6,100429,100588,100601,159,13,2410
ATAGTA,2.92919899858881,0.609717480825116,1.11109729529553,0.8047058146033521,6,101087,100624,100602,-463,-22,2411
GAATCC,3.2773800941358195,0.170847353208865,1.12180029578377,0.80456346702399,6,100425,100589,100603,164,14,2412
TACTAT,2.9273133974523105,0.613600021026906,1.1103699880761202,0.804149662847133,6,101089,100628,100604,-461,-24,2413
GTAAGA,3.1150355726796097,0.27372753143853695,1.11486298712424,0.8037984346442321,6,100799,100612,100605,-187,-7,2414
TCCAAT,3.23328026187384,0.282917149891736,1.1116729965219598,0.803664755356415,6,100536,100621,100606,85,-15,2415
TTGATT,3.39554468380943,0.521968681096743,1.09812470223772,0.8036051586451041,6,100150,100664,100607,514,-57,2416
CACCTT,3.7026716804051696,0.416613452158382,1.1088705317053602,0.803258827055202,6,99344,100635,100608,1291,-27,2417
ATCTAT,3.0798739544115494,0.50403710331033,1.10486043332647,0.802912239571663,6,100865,100642,100609,-223,-33,2418
TCATAC,2.8787578092649597,0.29487163026956,1.11969408408367,0.802717296045658,6,101144,100595,100610,-549,15,2419
CATGTC,3.54223927069091,0.5237104353713211,1.1118825401938501,0.802518302901964,6,99759,100620,100611,861,-9,2420
GGTAAA,3.23243610351324,0.13770334334538098,1.10963988578012,0.802215059706894,6,100540,100631,100612,91,-19,2421
TTTACC,3.23364748576235,0.132388343222281,1.10891224405163,0.801722192357261,6,100535,100634,100613,99,-21,2422
CTGGTT,3.66789648047108,0.00272153642419148,1.1071766792155602,0.801524567049734,6,99448,100637,100614,1189,-23,2423
TCATAA,3.1523836873842503,0.275941402314109,1.10076385612822,0.801177253344521,6,100732,100655,100615,-77,-40,2424
GCCAAT,3.27033810322744,0.15817267490957598,1.1169723267783,0.800963497404927,6,100439,100605,100616,166,11,2425
GCGTGA,3.03892033092939,0.116429174456426,1.13416127561465,0.800867628765823,6,100940,100554,100617,-386,63,2426
ACTAGC,2.8181985659289404,0.0105625720012057,1.1293800968086698,0.8007528081970631,6,101196,100566,100618,-630,52,2427
GTATGA,2.8755131048693596,0.304191371839623,1.11634888049832,0.8003425234347191,6,101149,100606,100619,-543,13,2428
TTGGCA,3.6980360044558003,0.35267182419104204,1.1045587787799198,0.8001322821352971,6,99357,100643,100620,1286,-23,2429
TATTAC,2.83675692104718,0.278034425026794,1.10697616528322,0.800031148554096,6,101177,100638,100621,-539,-17,2430
GGGTAG,3.3889619993092204,0.33597646678255394,1.12271619919927,0.8000213111088109,6,100164,100585,100622,421,37,2431
AATGTT,3.57775116060797,0.552289101608702,1.0885947219152,0.7996484665432622,6,99665,100688,100623,1023,-65,2432
AGCATC,3.50944926748474,0.448598457167485,1.10844533735593,0.7993797507083531,6,99859,100636,100624,777,-12,2433
TTTGAC,3.30044216172041,0.371408004442669,1.1038418291023702,0.799317383598068,6,100376,100646,100625,270,-21,2434
ACTACC,2.9532209734193997,0.33878280993479304,1.1226569387370902,0.7986988301060121,6,101050,100586,100626,-464,40,2435
CAAGCC,3.7416721341962202,0.319646629062095,1.1110977828575,0.7984328988555591,6,99210,100623,100627,1413,4,2436
TGCGCC,2.92934470281214,-0.320432564961612,1.1460050631271002,0.798316621369951,6,101086,100525,100628,-561,103,2437
GCTACC,3.154380970624,0.322058794624711,1.1266743601075802,0.7979048950507429,6,100723,100575,100629,-148,54,2438
CATGAA,3.6506498964977503,0.50494901984027,1.0931211246628,0.7976514684833391,6,99493,100675,100630,1182,-45,2439
TGCCAA,3.69131251412565,0.348631699501341,1.1013727965145301,0.797616806829519,6,99380,100653,100631,1273,-22,2440
GGCTTG,3.73602134555358,0.321725703665615,1.10917554129088,0.797123601732759,6,99229,100632,100632,1403,0,2441
GCGCCC,3.47015755322838,0.22269396879072503,1.1387860000593701,0.796822522916711,6,99956,100538,100633,582,95,2442
GTCCTA,2.9486097131022597,0.31535276956337605,1.11950676645421,0.796459763145481,6,101058,100596,100634,-462,38,2443
CCACGC,3.26553006785786,0.0127746274857987,1.13130109052295,0.7953961527050359,6,100450,100559,100635,109,76,2444
TTATGA,3.1475707304430003,0.280616702350594,1.0927742110092902,0.7953609415631708,6,100738,100677,100636,-61,-41,2445
CTTACT,3.1961760202331204,0.392403243010234,1.10099423999709,0.7953098719343141,6,100650,100654,100637,4,-17,2446
GCTAGT,2.8105940661606,0.011132345743376999,1.1217755970403402,0.7953020819911151,6,101199,100590,100638,-609,48,2447
TAGGAC,2.94731256063153,0.12576970923473,1.11707244897315,0.794696743110899,6,101061,100604,100639,-457,35,2448
TAGTTA,2.7546186617207598,0.42008539038712606,1.1014151013223301,0.794538295363323,6,101224,100652,100640,-572,-12,2449
TATGTC,3.06435675011239,0.453583978440724,1.10306592660441,0.794399895069692,6,100894,100649,100641,-245,-8,2450
GACATA,3.0680680671019602,0.39158441196041205,1.10296932623497,0.794305620189433,6,100892,100650,100642,-242,-8,2451
GACATG,3.5323836513954,0.512293228851805,1.1004653336743302,0.794089606498577,6,99789,100656,100643,867,-13,2452
TAGGGG,3.3404509758177596,0.0134876341532184,1.1155803012365502,0.7939652251068449,6,100288,100610,100644,322,34,2453
GGTCCT,3.54186728532765,0.13086408784019998,1.10993462636369,0.7938865312298531,6,99760,100630,100645,870,15,2454
GTCAAA,3.29228175409196,0.319352822446742,1.09651128032684,0.793771237573331,6,100393,100669,100646,276,-23,2455
GGGTTA,2.94441860240106,-0.024910953478117996,1.11563957877693,0.793713793997778,6,101068,100609,100647,-459,38,2456
TACCTT,3.22271906084484,0.478943733455704,1.09798381913412,0.793621936719639,6,100572,100665,100648,93,-17,2457
GGTGCT,3.7311540456562597,0.415382347359678,1.10430824139356,0.793534021990668,6,99247,100644,100649,1397,5,2458
ATTGGC,3.2578504276438998,0.150032383206797,1.1067309813297599,0.793471337774886,6,100466,100639,100650,173,11,2459
ATTGAT,3.0965806097349398,0.567157752720862,1.09105599436451,0.793214465836547,6,100831,100683,100651,-148,-32,2460
CCCCTA,3.3396638648866097,0.28807094800506605,1.1141453442575502,0.7927520578442221,6,100290,100615,100652,325,37,2461
GATGCT,3.49835393982059,0.451701063713822,1.09919304651987,0.7925892725023921,6,99893,100659,100653,766,-6,2462
TGCTAT,3.3763892832187996,0.445134314182484,1.09262629698854,0.7925585003503491,6,100194,100679,100654,485,-25,2463
ATAGAG,3.34892342074817,0.25275954473817003,1.09335494096907,0.7925453661876201,6,100273,100672,100655,399,-17,2464
TAACCC,2.94471810706968,-0.0338613252349145,1.1141540723873702,0.792479037009772,6,101067,100614,100656,-453,42,2465
AGTAAG,3.19428368356919,0.39840935175697295,1.09678531549898,0.7922243252063599,6,100652,100668,100657,16,-11,2466
GGTAGT,2.94235769029079,0.334464799038903,1.11357866666667,0.792205934235418,6,101071,100616,100658,-455,42,2467
GTAAAC,2.93659056245394,0.26904768365550197,1.1033636288594098,0.792108473730147,6,101077,100648,100659,-429,11,2468
ACCTCG,2.71831715937112,0.713679394646155,1.12989066498482,0.79083460300827,6,101238,100564,100660,-674,96,2469
AAGGTA,3.2160578594086497,0.483831123967089,1.09326164167553,0.7900765338249258,6,100597,100674,100661,77,-13,2470
GAAGTT,3.42224665545537,0.270193109434578,1.0880534712447298,0.7900497877305241,6,100083,100692,100662,609,-30,2471
ATAGCA,3.37606999220304,0.429055501732224,1.08890238192067,0.7897624014112831,6,100196,100686,100663,490,-23,2472
ATCAAT,3.0932826272349305,0.584094951236459,1.08551168172949,0.78904263981988,6,100835,100695,100664,-140,-31,2473
TCACGC,3.0225077428888305,0.0966764144921459,1.11784918676383,0.7889112218713149,6,100961,100603,100665,-358,62,2474
AAGCTT,3.41234057033661,0.39427116920405003,1.08633876584531,0.788590201997924,6,100109,100694,100666,585,-28,2475
AGGACC,3.53706380648263,0.122972274717259,1.10208734335365,0.78808301222899,6,99770,100651,100667,881,16,2476
GCAATC,3.2954605146704603,0.48635976757891797,1.09824585247072,0.788013108446338,6,100386,100662,100668,276,6,2477
GTTGTA,2.8926848542085697,0.24755033787257102,1.09823918347169,0.7877337760645721,6,101125,100663,100669,-462,6,2478
AGTCCA,3.49368116905699,0.27614902346618,1.09267723892818,0.7877174884551659,6,99900,100678,100670,778,-8,2479
GCGTGG,3.25152707119298,-0.00946140895974423,1.11908310491625,0.7866989778068081,6,100481,100599,100671,118,72,2480
TACAAC,2.89503694085,0.375149009128965,1.09688385194386,0.786626708578102,6,101123,100666,100672,-457,6,2481
GGTAGC,3.13841455928764,0.304463382010567,1.11103187179516,0.7865895584044421,6,100758,100626,100673,-132,47,2482
TGGACT,3.4898196020233305,0.24817548749980603,1.09065870872262,0.786277611704404,6,99911,100684,100674,773,-10,2483
GGGTAT,3.08711523152798,0.127080087305908,1.10026609619496,0.785582890246409,6,100849,100657,100675,-192,18,2484
GACATT,3.44688089558879,0.530396914868836,1.08108858087489,0.7853854065551099,6,100017,100704,100676,687,-28,2485
CACAAC,3.3597514795471697,0.33753953254228003,1.09253248365194,0.785035137327969,6,100236,100680,100677,444,-3,2486
ATATCC,3.12826011827214,0.24587054298604,1.08807822699053,0.7846944399641099,6,100778,100691,100678,-87,-13,2487
GACCAT,3.25026773141115,0.307164404877943,1.0946879330591,0.7846026812647221,6,100487,100671,100679,184,8,2488
GTATAC,2.6905238455055396,0.46579869765098,1.09830527309535,0.7837942008585059,6,101259,100661,100680,-598,19,2489
ATGGTC,3.2464746993247204,0.30524043976403603,1.0927804112206,0.7832535303599321,6,100497,100676,100681,179,5,2490
GTACCC,3.0445612236036896,0.293093781075244,1.1089359101371399,0.7830786223275079,6,100930,100633,100682,-297,49,2491
GGTTCA,3.6746737716916096,0.49376039717571796,1.08119654601573,0.7827926888863119,6,99425,100703,100683,1278,-20,2492
GATTTG,3.4410625107867996,0.345082701548215,1.07751652620791,0.782771470977912,6,100034,100710,100684,676,-26,2493
TCAACT,3.406952295102,0.505046152331646,1.07709409298613,0.7817459044520579,6,100127,100711,100685,584,-26,2494
AACTTT,3.52400755808524,0.299807668820845,1.06536221367781,0.781670074660442,6,99815,100738,100686,923,-52,2495
GATTGC,3.2892743979153596,0.48560622196215997,1.08888304753795,0.781267002313449,6,100403,100687,100687,284,0,2496
GTTTAC,2.92327815185248,0.269280660348469,1.08843611730428,0.7812360234057311,6,101093,100689,100688,-404,-1,2497
AATAGG,3.20208004417059,0.109977705976375,1.07928382643747,0.7797224911718679,6,100633,100706,100689,73,-17,2498
TACCCT,3.24758403202361,0.32219241185549297,1.08723388159106,0.7792151377721559,6,100492,100693,100690,201,-3,2499
ATACCC,3.0803676103252102,0.111720023442087,1.09173346393401,0.77918359102734,6,100863,100681,100691,-182,10,2500
TGAACA,3.62576506974527,0.48407310355877103,1.06823629791031,0.779071152262327,6,99559,100730,100692,1171,-38,2501
AATGTC,3.4317142292469596,0.534374441687707,1.07134493284575,0.7780436544396129,6,100062,100724,100693,662,-31,2502
CGAGGT,2.70049138584481,-0.44035135237692696,1.11082722725843,0.7772027780601741,6,101253,100627,100694,-626,67,2503
GGCCTA,3.3167515152969598,0.31753818311280607,1.09155691769181,0.7763146002723549,6,100339,100682,100695,343,13,2504
CTTGTG,3.66484134686297,0.30362741588425396,1.0723288954875199,0.7762428117074158,6,99459,100720,100696,1261,-24,2505
AACCAT,3.35198034266285,0.283266562015752,1.0707900901969,0.7761645539608921,6,100261,100726,100697,465,-29,2506
ATTGAA,3.3090638553571003,0.37065942500608295,1.06253087880233,0.776034426781165,6,100356,100741,100698,385,-43,2507
CCCTAC,3.35659047077216,0.32467648378554903,1.0897179535211199,0.7757028997320101,6,100245,100685,100699,440,14,2508
GTTTAA,3.19146063979459,0.23499612626933702,1.0640624991716499,0.7752106133697909,6,100657,100740,100700,83,-40,2509
ACTAAC,2.7355007859849603,0.24688765501812399,1.0850706204572902,0.775124459746157,6,101232,100696,100701,-536,5,2510
ATTACC,2.9608013824960095,0.23891216770126897,1.0786896029233102,0.774850785834977,6,101037,100708,100702,-329,-6,2511
ATACTC,2.84083979166663,-0.0154032210607173,1.08177606648534,0.7748194821450171,6,101171,100700,100703,-471,3,2512
GGGTAC,3.03217804366601,0.291766475483154,1.09687665322339,0.774399124448798,6,100950,100667,100704,-283,37,2513
GGCACT,3.70703118967905,0.326052100692459,1.07793905528134,0.7740506600302529,6,99324,100709,100705,1385,-4,2514
CTATGA,3.1619175046711803,0.25934856785694504,1.0715060765156401,0.7733890247398899,6,100709,100723,100706,14,-17,2515
TAAGCC,3.24037932077168,0.26037963836314,1.07887087642205,0.7730799548848779,6,100510,100707,100707,197,0,2516
TACCAA,3.1934925156580403,0.41914725045920603,1.070372374901,0.773052427693563,6,100653,100727,100708,74,-19,2517
ACTTAT,2.95436751203466,0.370734519497315,1.0665166445618,0.7728657689587021,6,101048,100734,100709,-314,-25,2518
AGTGCC,3.7038088031126297,0.322739684895728,1.07548078190891,0.772225722071244,6,99339,100712,100710,1373,-2,2519
TTACCA,3.2659142181259,0.22730278357013103,1.06706755537286,0.771996010951968,6,100448,100733,100711,285,-22,2520
AATTTG,3.54082824831667,0.319237984964198,1.0516718096239002,0.771932168515553,6,99762,100775,100712,1013,-63,2521
TTCAAT,3.3069321363829305,0.4641478642396189,1.05653772873948,0.771626478996784,6,100363,100761,100713,398,-48,2522
CCTATT,3.19287689700616,0.0949350283733867,1.06814165529545,0.771520391907935,6,100655,100731,100714,76,-17,2523
GGTAAT,2.95552999909667,0.232963204988762,1.07374214254789,0.7712804641352441,6,101044,100717,100715,-327,-2,2524
AACTCT,3.55342518954211,0.221855982577033,1.05916493641284,0.7712386439512131,6,99727,100751,100716,1024,-35,2525
CCTATG,3.2659916383335603,0.10605171105498801,1.07513039361567,0.7709251576517929,6,100447,100713,100717,266,4,2526
AAGATC,3.23323245486575,0.225079260853571,1.06621471653927,0.77079499850364,6,100537,100736,100718,199,-18,2527
AACCAA,3.57974619532893,0.494873913680801,1.0575475816786502,0.7704214396018421,6,99661,100756,100719,1095,-37,2528
GATCCC,3.3515792459070295,0.0443662989713403,1.0821631277085402,0.770269881416268,6,100262,100698,100720,436,22,2529
GGGATC,3.35096717643115,0.04663955405167999,1.08187498125659,0.770138257262524,6,100266,100699,100721,433,22,2530
GGCTTA,3.2347108606530695,0.28723479561918297,1.07468463324445,0.7700627667943559,6,100531,100714,100722,183,8,2531
ATGGTT,3.34478214048272,0.274760738630471,1.06230071008704,0.770049717587727,6,100283,100744,100723,461,-21,2532
GTAGGG,3.34797445187541,0.326708846890677,1.0817286517654598,0.7700201640497559,6,100277,100701,100724,424,23,2533
CCGCCC,3.6244713452363997,0.179195850686096,1.09528788195474,0.7696090814750479,6,99564,100670,100725,1106,55,2534
AGGGTA,3.23493088733774,0.318726561137247,1.07374636601203,0.769389171263639,6,100530,100716,100726,186,10,2535
TTGGTA,3.1893133796252595,0.495842029103494,1.0649020609384598,0.7691958822658491,6,100661,100739,100727,78,-12,2536
GAGTAT,2.8325740779516697,-0.018604115905255,1.07340985358063,0.7687548389013229,6,101182,100718,100728,-464,10,2537
TGGTAA,3.2557177658215397,0.22250301975259199,1.06219362219143,0.76836845120662,6,100470,100745,100729,275,-16,2538
TGTTCA,3.6124998316776096,0.465919810048968,1.05335595888898,0.7680809275292321,6,99592,100772,100730,1180,-42,2539
GCCTAC,3.15356062603328,0.0137583800878449,1.08450001889489,0.768021106819597,6,100726,100697,100731,-29,34,2540
CTTGTC,3.4633285017080597,0.528758704473296,1.06572919563134,0.767833972879099,6,99971,100737,100732,766,-5,2541
CCCACG,2.88907300712946,0.8234815132616758,1.10348703730941,0.767707262664575,6,101131,100647,100733,-484,86,2542
AAAGTT,3.5065038588351203,0.296145768137379,1.0467002205106,0.767690780652228,6,99868,100785,100734,917,-51,2543
CAAATC,3.4198149783876004,0.34731741257330395,1.05719935185138,0.7674845726000601,6,100091,100757,100735,666,-22,2544
GATGCC,3.53743435547792,0.320363994967503,1.07310509198069,0.767412262797967,6,99769,100719,100736,950,17,2545
GTCATA,2.86624806804329,0.400852143165558,1.0695560671714,0.7665823435043371,6,101155,100728,100737,-427,9,2546
GGCATC,3.5365972629303197,0.32002022495712396,1.07190717954601,0.7665406956988909,6,99773,100722,100738,949,16,2547
AGTTGT,3.22457546464427,0.23937044019815804,1.05878902042874,0.7654018311272429,6,100563,100753,100739,190,-14,2548
GTAAAG,3.2230930043847,0.30836720874963003,1.05892166112285,0.765382913807846,6,100571,100752,100740,181,-12,2549
GATCTT,3.22708049129695,0.20442964314401899,1.0584476520168,0.765160770547208,6,100556,100755,100741,199,-14,2550
GGGCGG,3.6167318744992,0.17900210140309802,1.08819625726539,0.7646505835207391,6,99585,100690,100742,1105,52,2551
CGTGGG,2.88201731049926,-0.598787556076141,1.09900159383815,0.764631611575144,6,101138,100660,100743,-478,83,2552
GGTCAT,3.2202003279386604,0.241683586020425,1.06650603983453,0.7639334125098829,6,100578,100735,100744,157,9,2553
GAGTAA,3.05986089287643,0.195947855226914,1.05968830732106,0.763028448665473,6,100903,100749,100745,-154,-4,2554
TATGCT,3.18193917622371,0.351931653002893,1.05624630170234,0.7627738091357801,6,100675,100764,100746,89,-18,2555
GATTGT,3.0604094260753594,0.239203159335734,1.0586217395663198,0.762361244311597,6,100901,100754,100747,-147,-7,2556
ACAACT,3.21892095738943,0.250158373256376,1.0544468200104,0.761998229807345,6,100584,100770,100748,186,-22,2557
ATCTAC,2.98329487158202,0.417745956519177,1.05982909538733,0.761712032363352,6,101018,100748,100749,-270,1,2558
TACTAA,3.10538557978446,0.550663842174709,1.0474338092239301,0.761569210123602,6,100812,100784,100750,-28,-34,2559
GTACTA,2.50607559795104,0.301359385509658,1.07192713724975,0.7614169591268809,6,101342,100721,100751,-621,30,2560
TATGAC,2.85832470390764,0.35670177733969105,1.06241794513651,0.761318870214425,6,101163,100742,100752,-421,10,2561
TTGGTT,3.56998443548437,0.475819511115704,1.0448795429506699,0.7612713536141309,6,99680,100789,100753,1109,-36,2562
GACAAG,3.45934676423158,0.506089580872708,1.05678124687877,0.7612203587901971,6,99981,100758,100754,777,-4,2563
ATAAGT,2.9352770549625498,0.35044262735081605,1.05050237647762,0.7609251749355891,6,101079,100777,100755,-302,-22,2564
TAGTAC,2.50534540441732,0.36596933715920293,1.07119694371603,0.760883114217582,6,101344,100725,100756,-619,31,2565
TTACTC,3.0573590414252596,0.19462461541193002,1.05567185410596,0.760102510826779,6,100905,100767,100757,-138,-10,2566
TTAGTA,3.1059973916999,0.543892411798195,1.0452722262686098,0.7600877315155509,6,100811,100787,100758,-24,-29,2567
AGCATA,3.1812750735887496,0.39233069482683003,1.0521775750152802,0.7597349550730659,6,100677,100774,100759,97,-15,2568
GTAGAT,2.9791019177601097,0.4620067863302729,1.0559389356825999,0.7589196876851441,6,101021,100765,100760,-256,-5,2569
GATATG,3.01746115902385,0.39924237398898293,1.05460874829187,0.758655031584288,6,100969,100768,100761,-201,-7,2570
CATATC,3.0180887470640703,0.5123237306685979,1.05455159342108,0.7585461847973121,6,100968,100769,100762,-199,-7,2571
TGAACT,3.56531793280855,0.45638339104240405,1.04054658539394,0.757916824345418,6,99699,100793,100763,1094,-30,2572
ATAATG,3.28452852749289,0.47056122861715205,1.03799555093812,0.757712562615863,6,100411,100801,100764,390,-37,2573
GATCAG,3.26195684285241,0.159386232756406,1.05655080093335,0.7575231893403259,6,100455,100759,100765,304,6,2574
CATAGG,3.24932934953105,0.0879065687985676,1.05654569770207,0.757287952075223,6,100489,100760,100766,271,6,2575
CGGGCC,2.91731717929551,-0.416773783901602,1.09964418672323,0.7571638761021949,6,101099,100658,100767,-441,109,2576
TTCTAG,3.5370387086079402,0.208726384041132,1.04000506060792,0.757093066637087,6,99771,100795,100768,1024,-27,2577
TTAGGA,3.3777110126742502,0.0644027598272317,1.04351782846362,0.756953920776979,6,100191,100790,100769,599,-21,2578
GACTAC,3.09889826256734,0.6418609432899971,1.0600345793022,0.756949820067193,6,100829,100747,100770,-82,23,2579
CCCTTA,3.21684691489106,0.24170791472196,1.05649676445852,0.7566202045760171,6,100596,100762,100771,166,9,2580
GTACTC,2.7741963985785496,0.135133530205881,1.06814150632192,0.756519164550483,6,101210,100732,100772,-478,40,2581
ATGACC,3.2120542299100094,0.244316922899257,1.05647443155796,0.7565093426643671,6,100611,100763,100773,152,10,2582
CTCATA,3.17561569619834,0.27109288131598996,1.0476764915419599,0.756391208819623,6,100688,100782,100774,94,-8,2583
TTAAGT,3.16517841858095,0.337720528831207,1.03778027795802,0.7556269599772478,6,100703,100802,100775,99,-27,2584
GCCCGC,3.41301170575456,0.16554812131689903,1.08164015258554,0.755624209220565,6,100106,100702,100776,596,74,2585
CTAGAA,3.5335946099456095,0.20316346987213602,1.03817606289926,0.755620526408912,6,99784,100799,100777,1015,-22,2586
CCAACC,3.67736663571189,0.49009597419174394,1.05276964218959,0.7553127793021841,6,99418,100773,100778,1355,5,2587
ACTTAA,3.1648740917660296,0.340232738044341,1.03601486310883,0.754258111012511,6,100706,100807,100779,101,-28,2588
GTCATG,3.3138957146238304,0.41393842366627703,1.05038413689787,0.7540908246753271,6,100342,100778,100780,436,2,2589
CTGATC,3.2557780711042703,0.17067044335589499,1.05153032310229,0.7538167044707859,6,100469,100776,100781,307,5,2590
GATAAC,2.65835282195679,0.36449966730110706,1.05579762126039,0.7528075339194099,6,101278,100766,100782,-512,16,2591
GGCCCG,2.91099863011913,0.578900325468249,1.09332563754685,0.7526748192142321,6,101105,100673,100783,-432,110,2592
GTAGTC,3.09100959670015,0.633275934805818,1.05401029477619,0.752588750249375,6,100840,100771,100784,-69,13,2593
GAGTAC,2.7699973579486095,0.1384427401309,1.06238087846797,0.752350072437907,6,101212,100743,100785,-469,42,2594
TGAGTT,3.5597905240108996,0.268542591834093,1.03224578172553,0.751857148581011,6,99715,100815,100786,1100,-29,2595
ACAACC,3.27772069964824,0.243789745318677,1.0480781920727,0.7516099252121509,6,100424,100781,100787,357,6,2596
AGTTCA,3.56168387007261,0.44445664881222596,1.0318927976522398,0.751553732455372,6,99710,100816,100788,1106,-28,2597
CATGAC,3.3113064122842997,0.458161641701556,1.0463337465240798,0.751050951563577,6,100350,100786,100789,436,3,2598
GTAGGC,3.1298057863209396,-0.00988662893823999,1.06104797329972,0.751033319015793,6,100775,100746,100790,-29,44,2599
CGGCTG,2.8628628671412004,-0.978656343746813,1.07984715048009,0.750843264603357,6,101160,100705,100791,-455,86,2600
GGCTAA,3.5976161101782203,0.251061572251098,1.03851140987636,0.7505171787238342,6,99624,100798,100792,1174,-6,2601
GCGGGC,3.40542008546869,0.165178299461315,1.07437245532361,0.7504838088595641,6,100130,100715,100793,585,78,2602
TATGAG,3.1663780261426497,0.246825630016755,1.03952685770419,0.7504236173952259,6,100699,100797,100794,98,-3,2603
TGAATT,3.51181125679621,0.43849162375189704,1.02265481810344,0.750177773620047,6,99850,100834,100795,984,-39,2604
AGATCT,3.2901548859838,0.0733146974628873,1.03574470012178,0.749788209488951,6,100398,100809,100796,411,-13,2605
CAAATT,3.5134393510001303,0.312154642894267,1.02203658217235,0.7496758898821341,6,99845,100835,100797,990,-38,2606
CTTGTA,3.16374892820193,0.351489749350133,1.03805605368056,0.749321545194083,6,100707,100800,100798,93,-2,2607
ACAATC,3.04092846345464,0.23656793033499,1.04085637708901,0.749056187694917,6,100936,100792,100799,-144,7,2608
CTTTAC,3.20268119561867,0.271037412429008,1.03659195728597,0.748901603134467,6,100632,100804,100800,172,-4,2609
GACTCA,3.4412602695899,0.263269435928208,1.03985304615418,0.7487126877528109,6,100032,100796,100801,764,5,2610
CATTAT,3.2761010320643402,0.466468725247369,1.0257066244209,0.7486105091712141,6,100426,100826,100802,400,-24,2611
TACAAG,3.16582132968691,0.3571181560791,1.03672383111344,0.7483087737026229,6,100701,100803,100803,102,0,2612
AATTAA,3.43477537517712,0.57722276100297,1.01336004044519,0.747945912278679,6,100052,100860,100804,808,-56,2613
GTTATC,2.6483867205103198,0.30454517009474796,1.04885419507219,0.747765511477309,6,101282,100780,100805,-502,25,2614
GCCTAT,3.1656714280097003,-0.0256785628261404,1.04506307598091,0.747536406065589,6,100702,100788,100806,86,18,2615
GGTTGT,3.27114326289853,0.222252085196915,1.0416706654275,0.7471519111133821,6,100436,100791,100807,355,16,2616
AATTCA,3.5094775014270096,0.430638583759214,1.0180747325992299,0.746707700581235,6,99858,100846,100808,988,-38,2617
GGTTGG,3.66585303274495,0.4712287524818621,1.0402887843168298,0.7464000358585409,6,99454,100794,100809,1340,15,2618
TGAGTC,3.4350618966667597,0.272601106781519,1.0363042966729599,0.7461315999941559,6,100050,100805,100810,755,5,2619
TTAAAC,3.15351772161403,0.190342547752929,1.0246584929568399,0.745803705077372,6,100727,100828,100811,101,-17,2620
TTGGAT,3.3111981854691703,0.45965672323851503,1.02871675507349,0.7451381981231241,6,100351,100821,100812,470,-9,2621
CTTGCA,3.62514559925616,0.396329416446372,1.0303868177456998,0.7451226758463191,6,99561,100818,100813,1257,-5,2622
TTAATT,3.43234797720048,0.5731802620726579,1.00931754151488,0.745001198419117,6,100060,100869,100814,809,-55,2623
ATCAAC,2.99176950500558,0.456977731921741,1.03554630439054,0.744364642303032,6,101010,100810,100815,-200,5,2624
TAGGCC,3.2727896944433903,-0.136686762061172,1.04759509683825,0.7442139683779498,6,100435,100783,100816,348,33,2625
TTAGCC,3.59173327260969,0.23808010061774001,1.0295312544131499,0.7439318483744991,6,99633,100820,100817,1187,-3,2626
AGTGTT,3.5486689219835603,0.41858634663339506,1.02112417969819,0.743574828740353,6,99744,100838,100818,1094,-20,2627
CTTTAA,3.47311076657911,0.248910877314715,1.01446542217168,0.743530563376708,6,99947,100855,100819,908,-36,2628
GTTGAT,2.98637100704287,0.45694815002878497,1.03385522459709,0.7432205704517341,6,101016,100814,100820,-202,6,2629
AATCTT,3.31165781449219,0.16339651222537,1.01741452109815,0.743129703588865,6,100349,100849,100821,500,-28,2630
TGTACT,3.15433783710921,0.34207865825740696,1.02864496258784,0.742366316808937,6,100724,100822,100822,98,0,2631
TCCTAA,3.35370468513983,0.0447759445004721,1.02384648302396,0.742208130871794,6,100256,100830,100823,574,-7,2632
CACAAG,3.62463654496486,0.271480188292644,1.0264731394023001,0.7421982221539449,6,99562,100825,100824,1263,-1,2633
TAAGGG,3.19700253827619,0.0847346625272376,1.03581801695048,0.741526223681117,6,100648,100808,100825,160,17,2634
GTTATG,2.82909458230685,0.232000261894573,1.03464891156997,0.74097809042568,6,101187,100813,100826,-374,13,2635
TCTTAA,3.3076405497531,0.15937924748628,1.01339725635906,0.740130972111715,6,100361,100859,100827,498,-32,2636
TTAAGA,3.3088776876194306,0.17193735131568696,1.01307280700139,0.739908698219302,6,100358,100861,100828,503,-33,2637
CATCAA,3.3822066110957403,0.447543043905037,1.0195909845595201,0.739557389239536,6,100179,100844,100829,665,-15,2638
GTTAGT,2.68923182839877,0.21033858893040303,1.0360282680003299,0.73941424001212,6,101261,100806,100830,-455,24,2639
TTAAAG,3.4679369062027097,0.257578815504973,1.00813326787819,0.7388042926876821,6,99962,100874,100831,912,-43,2640
CCAATA,3.1470046962916,0.192864750580922,1.0238845555345601,0.7386795588344641,6,100740,100829,100832,89,3,2641
GCTGCG,2.65434129720331,0.7647012794646558,1.06881356763092,0.7386295885102241,6,101279,100729,100833,-550,104,2642
AGTACA,3.15242813066124,0.343724957053434,1.02333063208777,0.738410758061064,6,100731,100831,100834,100,3,2643
CTAAAT,3.22865269144614,0.0391415822102772,1.01263080917671,0.7382648473363091,6,100552,100863,100835,311,-28,2644
CTTGAC,3.2618183579255997,0.48880409738557,1.02960311658573,0.7382061912273391,6,100456,100819,100836,363,17,2645
AGTCTA,2.9594422045209505,0.278734104000629,1.02750418138123,0.738097720039524,6,101041,100823,100837,-218,14,2646
ATTTAG,3.23089821780577,0.0364548063069723,1.01210294066559,0.737992182395501,6,100544,100864,100838,320,-26,2647
TAGACT,2.95967410650475,0.142808043218675,1.02733279005811,0.737978151782749,6,101040,100824,100839,-216,15,2648
AATACC,3.1458449770713597,0.191705031360678,1.02272483631431,0.737823383440135,6,100743,100833,100840,90,7,2649
AACCCT,3.58082226062416,0.256352167562811,1.02139363729838,0.737785732985422,6,99658,100837,100841,1179,4,2650
TTGATG,3.3801080584735095,0.44040605275364103,1.01656207389462,0.737481989071688,6,100186,100852,100842,666,-10,2651
AGATTG,3.30107688803824,0.236938452048928,1.01615560789088,0.7358276435819321,6,100374,100853,100843,479,-10,2652
GGTTTG,3.60874342519623,0.285078704995666,1.01751252965536,0.7356531873710859,6,99604,100848,100844,1244,-4,2653
CTTAAG,3.11631709565374,0.098247694521179,1.0199770215006199,0.7354143599686709,6,100797,100843,100845,46,2,2654
ATTGCC,3.37180182798532,0.27012937454535,1.02287047155854,0.7353180488543442,6,100204,100832,100846,628,14,2655
AGTTGA,3.34844867338818,0.4380994680365671,1.0142554891775502,0.7352419449444291,6,100275,100856,100847,581,-9,2656
CATAAC,2.8232649647683,0.213527175572684,1.02511187586216,0.733874472577957,6,101192,100827,100848,-365,21,2657
GGCAAT,3.3714330200906097,0.268692301963858,1.02057925655274,0.733658895676634,6,100207,100840,100849,633,9,2658
AAGATT,3.30020116809925,0.16326083179551198,1.00439628748121,0.7334344097572141,6,100378,100885,100850,507,-35,2659
AATGCC,3.60400342061949,0.261322605995177,1.01406370300836,0.7329200458852441,6,99611,100857,100851,1246,-6,2660
TTCTAA,3.45857003089942,0.16864600992520298,0.9999246864919871,0.73264849524967,6,99985,100893,100852,908,-41,2661
GTCAAG,3.25490510107193,0.33661145483700106,1.02074632371422,0.731726752660428,6,100473,100839,100853,366,14,2662
TATGGG,3.2120566825045698,0.0142133489675107,1.0215193608106101,0.731603915991559,6,100610,100836,100854,226,18,2663
GATAGC,2.8307748818878595,0.21789886427128602,1.03107710535736,0.7313342030357841,6,101184,100817,100855,-367,38,2664
ATAGAC,2.94252013669191,0.261076265065448,1.01789606658014,0.730854362571495,6,101070,100847,100856,-223,9,2665
GGTACA,3.2132754229792404,0.340886096115932,1.02049177115027,0.730804712355537,6,100606,100841,100857,235,16,2666
TTAGAA,3.45707938296812,0.162263151616475,0.9972757446435949,0.7306796206764179,6,99992,100901,100858,909,-43,2667
CCCATA,3.21311784149938,0.00671804804973242,1.0200102666464899,0.73037897573614,6,100607,100842,100859,235,17,2668
ATCCAA,3.29009266154929,0.416691227254791,1.00890240908334,0.7302774100014,6,100399,100871,100860,472,-11,2669
ACCTAG,3.2223125286270298,0.215546971400691,1.01945008765541,0.7301812884308628,6,100573,100845,100861,272,16,2670
CAAGCT,3.57573725564471,0.41314723358521,1.01033127450251,0.7297460839310141,6,99668,100867,100862,1199,-5,2671
GGCATT,3.60242904471162,0.257064864446862,1.00895181903574,0.729278446879427,6,99616,100870,100863,1254,-7,2672
CTCTAT,3.2611147357561703,0.170553889975432,1.00786284381124,0.729125542885915,6,100458,100875,100864,417,-11,2673
GGTATT,3.1347806809689502,0.18142762202572602,1.0103693622821501,0.7288819431470892,6,100765,100866,100865,101,-1,2674
GGCGCA,2.83424029695393,-0.41820291366713,1.04897825015781,0.728719390780769,6,101181,100779,100866,-402,87,2675
GCCGGC,2.87725135181617,-0.54454394836924,1.05957835924389,0.7286877750000841,6,101145,100750,100867,-395,117,2676
ACCTAT,2.9379486114871,0.210579719037696,1.01448283529241,0.7283293374254671,6,101076,100854,100868,-222,14,2677
CTAGGT,3.21819727915224,0.22119480958094898,1.01679592621488,0.728289834719195,6,100588,100851,100869,263,18,2678
CAAGTC,3.4129732581393397,0.47525513322570795,1.01196932801053,0.7281488595669009,6,100107,100865,100870,758,5,2679
AGGGTT,3.56959769624667,0.252699796199272,1.0077196010740601,0.727872603768391,6,99685,100876,100871,1191,-5,2680
CTTGTT,3.52630929623479,0.46361722756002205,0.9999228478665179,0.727782572900475,6,99806,100894,100872,1088,-22,2681
CAATCT,3.29119780824504,0.23748441588665697,1.00518849187977,0.7276492838434521,6,100396,100882,100873,486,-9,2682
ATAACA,3.2464573316575702,0.43024370264682704,0.997678024967799,0.7276059576410909,6,100498,100900,100874,402,-26,2683
AACAAG,3.5278704562251697,0.456697842693433,0.999694484758463,0.727480378835208,6,99799,100896,100875,1097,-21,2684
ATAGGC,3.13881608047756,-0.0538851677062731,1.01704943453168,0.72701173977272,6,100757,100850,100876,93,26,2685
ATATAG,2.97811616646873,0.159736667462068,1.00194435146656,0.726457346940487,6,101022,100887,100877,-135,-10,2686
TATTGG,3.13135258667032,0.177999527727101,1.0069412679835301,0.726351065985485,6,100770,100879,100878,109,-1,2687
AGCTTG,3.5688038082212206,0.40846011629671997,1.00564415721402,0.726323649857136,6,99687,100881,100879,1194,-2,2688
TGTACC,3.20485672475455,0.32742917570623403,1.01399548003666,0.726009914999977,6,100628,100858,100880,230,22,2689
CTATAT,2.97521527525464,0.157994070165058,1.00020175416955,0.725151186188346,6,101024,100892,100881,-132,-11,2690
ATAGGT,2.9329744183935804,0.214210319682131,1.0098114363160602,0.724966493985366,6,101081,100868,100882,-213,14,2691
GACTTG,3.40579359892972,0.476384612627331,1.00663270562901,0.724267599827203,6,100129,100880,100883,751,3,2692
GGAATT,3.51758773672155,0.286609752257657,0.9940979451415279,0.7233588291184809,6,99834,100912,100884,1078,-28,2693
GGGCGC,3.3665532919793497,0.126311505971966,1.0355056618342602,0.7225401578430559,6,100215,100811,100885,596,74,2694
TGTTAT,3.2386496468997503,0.43126367021778494,0.990501569391315,0.7224026402279721,6,100517,100919,100886,402,-33,2695
AACTTA,3.0526033760489,0.511272937411713,0.9946516054883701,0.7223426284123929,6,100914,100911,100887,-3,-24,2696
GTCTAT,2.9267103298635,0.259083906441816,1.00470564170307,0.7211981016308611,6,101091,100884,100888,-207,4,2697
GTATAA,2.88136912655253,0.364836032406082,0.9965944480676079,0.7209903596406959,6,101140,100903,100889,-237,-14,2698
CTCAAT,3.28192451683221,0.21933159024096802,0.9959152004669359,0.720783130522332,6,100416,100907,100890,491,-17,2699
CAAACC,3.58912415722544,0.28705617020122903,0.9969381094793079,0.7202161307094699,6,99638,100902,100891,1264,-11,2700
CTTATC,2.9313078612088104,0.327461098019976,1.00052813198617,0.7182399206739959,6,101083,100891,100892,-192,1,2701
GCATAC,2.8037208189726504,0.27619370412145,1.0128985826941,0.717896581617469,6,101201,100862,100893,-339,31,2702
ATTGAG,3.2758757319752903,0.227251261936493,0.990954451827932,0.7171661454466071,6,100428,100918,100894,490,-24,2703
GGCATA,3.19259941246275,0.24792880604489698,0.9998157606337801,0.715637073200278,6,100656,100895,100895,239,0,2704
GATAAG,2.9296115115077104,0.326929913403267,0.9961119011439871,0.715029477165006,6,101085,100906,100896,-179,-10,2705
TATGCC,3.18986982515701,0.194364409765587,0.999008580439119,0.715016770545208,6,100660,100898,100897,238,-1,2706
GTATGC,2.79780127712296,0.281004793615457,1.00844012887866,0.7147147498354139,6,101203,100873,100898,-330,25,2707
CGCAGC,2.62261417704177,-0.7163865282217758,1.03484011733438,0.7143667470168571,6,101294,100812,100899,-482,87,2708
CTAGAC,3.1991931718888,0.239510929402494,0.9963307309171809,0.7132190298122092,6,100643,100905,100900,262,-5,2709
CCATAC,2.9895109748246003,0.21335330025224802,1.0008768284334002,0.7127148674132291,6,101013,100890,100901,-123,11,2710
TGCATC,3.41964244311917,0.355228311322774,0.989285712622104,0.711982675593815,6,100093,100920,100902,827,-18,2711
GATGTT,3.34535771018179,0.44550610529640794,0.9818117256029041,0.7117141079157929,6,100282,100928,100903,646,-25,2712
GTATGG,2.9847692517254503,0.210380144935868,0.997920116392434,0.7106869465057271,6,101017,100899,100904,-118,5,2713
GGAATC,3.3829136889070295,0.280722846734704,0.988211039618573,0.71058491460573,6,100178,100922,100905,744,-17,2714
GTTACC,2.83072656947219,0.31897287442176697,1.00162362282414,0.710447348680832,6,101185,100889,100906,-296,17,2715
GTTAAC,2.61063287138817,0.224704208855515,0.995817614582323,0.7092349090238679,6,101300,100908,100907,-392,-1,2716
CCTATC,2.99084966830252,0.14746959339854,0.994901568883373,0.7085270277932479,6,101011,100910,100908,-101,-2,2717
GATAGG,2.99035616443375,0.14481801824120802,0.9931704008145219,0.707359484020983,6,101012,100915,100909,-97,-6,2718
GATGCA,3.4145766782637,0.34860095924330503,0.982658360542635,0.7071225219156079,6,100102,100927,100910,825,-17,2719
TAAGTT,3.03394172071352,0.39672673127064706,0.973216555282232,0.7065554799134279,6,100947,100940,100911,-7,-29,2720
ATTGTC,3.09908885989448,0.43426958880293,0.9797279246776078,0.7061516832011059,6,100827,100934,100912,107,-22,2721
TACTCC,3.14750952361431,0.00248381176825418,0.987159373181758,0.705764293870955,6,100739,100923,100913,184,-10,2722
CTCGCT,2.6961636638944704,-0.512946754797323,1.00850348869129,0.705486256195087,6,101255,100872,100914,-383,42,2723
AAGGTC,3.37524967579943,0.37111650880253705,0.980547026510973,0.704944566183747,6,100198,100932,100915,734,-17,2724
GGTAAC,2.82340908002559,0.308480765709408,0.9931689683672079,0.704312508694139,6,101191,100916,100916,-275,0,2725
GCTATC,2.79174781443045,0.190644865443904,0.99361162512395,0.7040543059426508,6,101206,100913,100917,-293,4,2726
AGATAG,3.2287211480363602,0.37922051890493297,0.97315266825726,0.70348099460352,6,100551,100941,100918,390,-23,2727
GCATAG,3.10641095672689,0.24793943220836698,0.984644310781015,0.7032849199090171,6,100809,100924,100919,115,-5,2728
AGTCAA,3.30107727476874,0.39801283808129495,0.97006077873578,0.7023738780719591,6,100373,100946,100920,573,-26,2729
AGCGAG,2.6939689598269903,-0.519486669272618,1.0039921967896401,0.702274470621748,6,101257,100886,100921,-371,35,2730
CTATGC,3.1037568401063402,0.255713152814348,0.9831484880775521,0.70217448154645,6,100816,100926,100922,110,-4,2731
GGAGTA,3.1425492682104905,-0.00241660160843615,0.9813647468847841,0.7016066747891,6,100747,100930,100923,183,-7,2732
TTGACA,3.33341544879361,0.37192292960125795,0.9676231340797141,0.701163831632684,6,100294,100950,100924,656,-26,2733
CTTACC,3.1403417102227302,0.30527572002116105,0.979991559790184,0.700515657286391,6,100753,100933,100925,180,-8,2734
TGGCCG,2.8253788482069506,0.472117138021563,1.00770585563467,0.6999173597962509,6,101189,100878,100926,-311,48,2735
CGGCCA,2.82538818289887,-0.6856225251183119,1.00771519032658,0.6998288749895981,6,101188,100877,100927,-311,50,2736
TTGGAC,3.20820946176261,0.4082157444223571,0.9772757762573259,0.6998130722142221,6,100616,100936,100928,320,-8,2737
GTAGTA,2.74389742164298,0.47742473680394204,0.9788045512743541,0.6994771084087991,6,101228,100935,100929,-293,-6,2738
TGTCAA,3.3256731990510398,0.372653623990978,0.9653039026498291,0.699360235341112,6,100318,100952,100930,634,-22,2739
AGTGTC,3.37153813641096,0.3702427033523621,0.9727805364171579,0.699341588568902,6,100206,100942,100931,736,-11,2740
AATTAC,3.0909186147311,0.525922106631681,0.9620593860739041,0.699270488387282,6,100841,100962,100932,121,-30,2741
AATTCC,3.48532111333799,0.267723410832776,0.9615073987340409,0.699075922860947,6,99923,100963,100933,1040,-30,2742
TTGACT,3.29819145399347,0.389000542558946,0.9651565636999259,0.698856349203804,6,100383,100953,100934,570,-19,2743
ATCTCG,2.4058963750943,0.649164306478447,0.996474570750962,0.698832649424973,6,101380,100904,100935,-476,31,2744
ATGGCG,2.58743687031916,0.6221738625903511,1.00190914074677,0.6987633594205479,6,101306,100888,100936,-418,48,2745
GACACT,3.37266775843259,0.367647820239146,0.971260534996866,0.6981889126985611,6,100200,100945,100937,745,-8,2746
CGGGGA,2.8223577596546296,-0.588809282845345,1.00500869010627,0.6979803517426411,6,101194,100883,100938,-311,55,2747
GTAATT,3.08753787222201,0.43358787247979796,0.960139731599073,0.697896210621766,6,100847,100966,100939,119,-27,2748
CTTGAT,3.24804292647026,0.434031847238312,0.9642799402399901,0.6974215251129499,6,100491,100955,100940,464,-15,2749
CTATCT,3.21729931618268,0.36322409422161994,0.964047424237757,0.696725403078209,6,100593,100956,100941,363,-15,2750
CGCCAT,2.58680685308938,-0.38454160748785793,0.9990327933819929,0.696661021208097,6,101307,100897,100942,-410,45,2751
GACAAC,3.04842078568061,0.426108011989061,0.9767996779951189,0.6965931709197509,6,100920,100937,100943,17,6,2752
CAAGCG,2.71502314618249,1.1898055021523402,0.993447252641875,0.695264337055666,6,101243,100914,100944,-329,30,2753
CGAGAT,2.40205972776015,-0.534657931495836,0.991479629499727,0.6952495083574711,6,101384,100917,100945,-467,28,2754
TTATAC,2.84927228355176,0.402183516905371,0.9614214160788991,0.6950367552136889,6,101170,100964,100946,-206,-18,2755
AGTGTA,3.0902996861290895,0.276882213360205,0.963448517690635,0.6942696395707901,6,100843,100959,100947,116,-12,2756
ATCAAG,3.24652343771791,0.32822979148298803,0.959355827435552,0.6937565368213942,6,100496,100967,100948,471,-19,2757
GTTGTC,3.0379349929116897,0.37311572182014396,0.9715828906194781,0.692860798330058,6,100942,100944,100949,2,5,2758
GGTAAG,3.1299609613323502,0.306204203567409,0.968776440006643,0.6923912179239179,6,100773,100948,100950,175,2,2759
GTCAAT,2.91913547472934,0.41959085879707003,0.964373362148566,0.6920777166386,6,101097,100954,100951,-143,-3,2760
ATTGGG,3.31239849915564,-0.0435149460903155,0.963791065752782,0.6919370322905849,6,100347,100958,100952,611,-6,2761
AACATC,3.31788522164939,0.41227295304814704,0.955269595113174,0.691894176006302,6,100337,100977,100953,640,-24,2762
GACCTT,3.36072618265073,0.34348283648225003,0.9625229221606658,0.691752541914005,6,100234,100960,100954,726,-6,2763
TCCCCG,2.81305260438194,0.417801817780141,0.995055688785733,0.690798892623556,6,101197,100909,100955,-288,46,2764
GACAAT,3.08105436551192,0.40719384692998,0.95788551293604,0.690034353444224,6,100859,100970,100956,111,-14,2765
ATAATC,3.00282661290013,0.38377245932313503,0.951206781644105,0.690020310474689,6,100991,100981,100957,-10,-24,2766
TACACT,3.0843793492455602,0.276834469554837,0.956440144589175,0.689051969476958,6,100853,100974,100958,121,-16,2767
AACCTA,3.07968919563256,0.425409193076391,0.956569054875514,0.689027727099354,6,100867,100973,100959,106,-14,2768
GACCAA,3.35448132188379,0.39521949434955606,0.9578931623474031,0.688239603601806,6,100253,100969,100960,716,-9,2769
TGATTG,3.2646085752997402,0.33217455800031104,0.950334494784133,0.687631877826392,6,100451,100985,100961,534,-24,2770
GGATTG,3.30652313489422,0.235927313277784,0.9579157014913591,0.6876213371808549,6,100364,100968,100962,604,-6,2771
TTGGTC,3.35304136915303,0.38766358707592896,0.956723618910898,0.68753623092905,6,100259,100972,100963,713,-9,2772
GCAATT,3.2750454771085398,0.33715758772543797,0.949043672617243,0.686786970031164,6,100431,100989,100964,558,-25,2773
TCAATG,3.30771706490745,0.37529982785175897,0.947347768506242,0.6860708324238421,6,100360,100993,100965,633,-28,2774
TACCCC,3.1932220997804506,0.0626691960474357,0.9677035791513809,0.6859739035019821,6,100654,100949,100966,295,17,2775
GGAACT,3.5101153287839706,0.24352243559824202,0.9510106284821109,0.68588799671248,6,99855,100982,100967,1127,-15,2776
ACCTAA,3.1149443776527,0.146567124018958,0.9504702402736759,0.6852014348023361,6,100800,100984,100968,184,-16,2777
CCAGCG,2.7425142556784703,0.674308639096493,0.9885274163616901,0.6848392884398979,6,101229,100921,100969,-308,48,2778
TAGGTT,3.0746361853663395,0.307242953614198,0.9502248666795451,0.684529197105083,6,100875,100987,100970,112,-17,2779
ATAGCT,3.20183493563218,0.35024070885286396,0.947424749770164,0.684463086815712,6,100634,100992,100971,358,-21,2780
CAATCA,3.2635707077794396,0.332210639719072,0.9448039669938191,0.683465441105655,6,100453,100995,100972,542,-23,2781
AATTGC,3.2702978278811003,0.341019197814008,0.9442960233898,0.683277784307446,6,100440,100997,100973,557,-24,2782
CTAATT,3.3924598128078403,0.49767718895818003,0.9338144684004029,0.6832496217423609,6,100157,101017,100974,860,-43,2783
GATTAT,2.9960208323157995,0.381986413708562,0.941224312882092,0.6827472729543349,6,100998,101007,100975,9,-32,2784
GATTCC,3.34845328400626,0.25646603561493103,0.9502500235161959,0.682732675577054,6,100274,100986,100976,712,-10,2785
GGGGTA,3.1872766752036,0.14502719240908998,0.9624060006223871,0.6822713920091461,6,100664,100961,100977,297,16,2786
ACTAGT,2.64562594489588,0.0640482369933331,0.956807475775612,0.6820503321007739,6,101285,100971,100978,-314,7,2787
CGCTGG,2.7368818300411,-1.14406116030204,0.984377207665336,0.6819458244859999,6,101231,100925,100979,-306,54,2788
AATTAG,3.39177211776839,0.49583120000164294,0.931968479443865,0.6818849096564771,6,100160,101022,100980,862,-42,2789
GACTTA,2.8833281181079196,0.467608133584626,0.9509868016612829,0.681881666969979,6,101136,100983,100981,-153,-2,2790
AATTGA,3.23088092132729,0.358920019568265,0.935076040709244,0.681789110211472,6,100545,101016,100982,471,-34,2791
GACACC,3.4225041887544703,0.263671515575247,0.955928595122227,0.6815908013848301,6,100082,100976,100983,894,7,2792
AGTTCC,3.5066061999273597,0.250620193829549,0.9444041817308141,0.681072444997661,6,99866,100996,100984,1130,-12,2793
GATGTA,2.91184179813784,0.26242308307543105,0.948989387405861,0.68095425192502,6,101104,100990,100985,-114,-5,2794
GCATAA,3.02936727716745,0.209284056241517,0.9459889348141619,0.6806334037254991,6,100954,100994,100986,40,-8,2795
CGGCAG,2.7668373913526803,-0.9655895546708101,0.9815753445565569,0.68055633451834,6,101217,100929,100987,-288,58,2796
CGCACC,2.76624326241669,-0.23903463533413,0.9806572925966459,0.679816656807241,6,101218,100931,100988,-287,57,2797
TCAATT,3.2266220897562,0.3603308557076839,0.932378796362167,0.679763868049434,6,100557,101021,100989,464,-32,2798
TTATGC,3.0284467565564,0.21601797798623498,0.9434533132494392,0.6788751445714339,6,100955,101002,100990,47,-12,2799
TGATAA,3.17695682812109,0.36298952924535,0.930423851566323,0.677596914647131,6,100685,101024,100991,339,-33,2800
GGTGTC,3.4124239174200297,0.261054270136841,0.949980164170723,0.6773372230572939,6,100108,100988,100992,880,4,2801
ATTGAC,2.89798615869807,0.40321026901788704,0.9440092882180459,0.6771192821701569,6,101118,100998,100993,-120,-5,2802
TTAGGT,3.10476138658687,0.14337382573740803,0.9389749423713399,0.676903000150681,6,100813,101009,100994,196,-15,2803
AGTATC,2.8755394601673596,0.442221622557225,0.943601437027638,0.676459013183388,6,101148,101001,100995,-147,-6,2804
CCATAA,3.2169415307766496,0.14822775012955702,0.9357512783107091,0.6761917702907939,6,100595,101014,100996,419,-18,2805
GTCAAC,2.85476219246203,0.31997041937819204,0.95154782477165,0.675303237737398,6,101165,100979,100997,-186,18,2806
TAAGTC,2.8731825567194105,0.227744150369446,0.941244533579688,0.6747305646066659,6,101151,101006,100998,-145,-8,2807
GTATCA,2.89543440195269,0.387203269446839,0.9406722893719159,0.67468373967822,6,101122,101008,100999,-114,-9,2808
CACACG,2.7170209352609502,0.788335227269458,0.9638459112170691,0.674546233515013,6,101240,100957,101000,-283,43,2809
GTCCAA,3.17112941291267,0.297727978618173,0.942947993371384,0.6745419277300561,6,100693,101003,101001,310,-2,2810
GATATC,2.7119417979273797,0.392174411144479,0.9440025324941371,0.674037244598154,6,101246,100999,101002,-247,3,2811
TTACCC,3.1733910294714702,0.15067235835726,0.9421334209422549,0.674001826405073,6,100691,101004,101003,313,-1,2812
GTAGCA,3.1760551667374903,0.282049509191337,0.941896389379785,0.673907743920646,6,100686,101005,101004,319,-1,2813
CATTGA,3.2964665003369302,0.35451816448205503,0.9306741856230349,0.6738234470932021,6,100385,101023,101005,638,-18,2814
GGTGCG,2.75502577471514,1.07490606592206,0.972010058054027,0.673779928632599,6,101223,100943,101006,-280,63,2815
GTTGAC,2.84953248994524,0.39162112211696604,0.9485644523898711,0.6731774579127391,6,101168,100991,101007,-177,16,2816
GTCGCC,2.56514149245262,-0.262832767123664,0.9767149980663191,0.673119732648785,6,101315,100938,101008,-377,70,2817
TTATCA,3.1744392235175,0.364806916700529,0.924044815874058,0.672918507843412,6,100689,101037,101009,348,-28,2818
CGTGTG,2.70947738548658,-0.726372691076577,0.960795021712711,0.672444063611999,6,101249,100965,101010,-284,45,2819
CCCAAT,3.28805735166829,-0.0764125534902593,0.9368796651064971,0.672074272212984,6,100404,101012,101011,608,-1,2820
AGCTAT,3.1847635142233996,0.333169287444088,0.930353328361388,0.671864532420903,6,100668,101025,101012,357,-13,2821
ATAAGC,3.01700528146287,0.34435268098489596,0.933626939109578,0.6715417588360161,6,100970,101018,101013,48,-5,2822
GGCGAC,2.5640068678371,-0.267367333470824,0.9743427092507191,0.671461327090317,6,101316,100939,101014,-377,75,2823
CGGAGC,2.72262631232426,-0.43695627040406,0.968963396031405,0.6709324842677049,6,101236,100947,101015,-289,68,2824
GGAGCG,2.7207238224791097,0.775101459594945,0.96706090618625,0.669620641812679,6,101237,100951,101016,-286,65,2825
CAATCC,3.28469545272061,0.230704250022484,0.933517766158818,0.6696076026635029,6,100410,101019,101017,609,-2,2826
TGCTAC,3.1682463788530697,0.288539154707154,0.9360311375132041,0.669587889275046,6,100695,101013,101018,318,5,2827
TAAGCT,3.02656243077563,0.20784157098536604,0.9302223566225191,0.669284515454715,6,100958,101026,101019,68,-7,2828
TTATGG,3.2078503775818397,0.137828975729587,0.9253689471861508,0.6686945778237889,6,100619,101033,101020,414,-13,2829
GGGTAA,3.16072396112831,0.146126732194237,0.9328664646109509,0.6672320054620121,6,100711,101020,101021,309,1,2830
CGTGAT,2.39120731335522,-0.370065437474079,0.9512744147265408,0.6669039179286209,6,101390,100980,101022,-410,42,2831
TGGACC,3.3999105165718198,0.09309803185177401,0.9355812530745842,0.6667829731696949,6,100141,101015,101023,874,8,2832
TGATAC,2.88015298175057,0.381799241820582,0.926176111270545,0.6640404714668571,6,101141,101030,101024,-111,-6,2833
TACATC,2.88920198658515,0.246059157907826,0.9256648329421641,0.6637842703903011,6,101130,101032,101025,-98,-7,2834
CCAACT,3.4803432877728597,0.35824099644923607,0.920914664447084,0.6636504253540699,6,99932,101043,101026,1111,-17,2835
GCTTAT,3.00764751937927,0.34440494817955203,0.922654076072311,0.663580993482448,6,100985,101040,101027,55,-13,2836
TGATCA,3.23407075971539,0.27128831418237104,0.9175503490647741,0.663373020900689,6,100532,101046,101028,514,-18,2837
AGCTTA,3.0182871222269796,0.324763007156568,0.92194704807387,0.663200266678619,6,100967,101041,101029,74,-12,2838
TAGATC,2.69697743249018,0.145889490324276,0.9290381670569392,0.663106130145619,6,101254,101028,101030,-226,2,2839
CTGCCG,2.73969637063173,0.667551041463032,0.956356730946689,0.662543571747614,6,101230,100975,101031,-255,56,2840
GAAACG,2.4314881530739103,0.781962122309833,0.94389845133562,0.6623748627325059,6,101368,101000,101032,-368,32,2841
GATCTA,2.69587118206308,0.179161839249245,0.9279319166298449,0.662298147320193,6,101256,101029,101033,-227,4,2842
GCTCCG,2.7080743958796205,0.756686147286485,0.9552458504799191,0.661154315753781,6,101250,100978,101034,-272,56,2843
TACTAC,2.69151909316307,0.409603697586853,0.9261234286772829,0.660898418085038,6,101258,101031,101035,-227,4,2844
GGATCT,3.23941594653912,0.0161183723910892,0.921319607421605,0.6602454054296589,6,100516,101042,101036,526,-6,2845
AGTATG,3.0436829839422597,0.34547143769918703,0.9168318155038001,0.659951761007951,6,100933,101047,101037,114,-10,2846
CATACT,3.04455123065237,0.3402816219176599,0.9166120259959879,0.659738720692045,6,100931,101048,101038,117,-10,2847
CTCTAG,3.44843812485471,0.0784806142970425,0.915789568132851,0.6595359045593051,6,100012,101051,101039,1039,-12,2848
GACATC,3.15772748396017,0.370030645531786,0.9207223115378441,0.6584248405797379,6,100715,101044,101040,329,-4,2849
AGTTGG,3.4753764746373097,0.344438347629724,0.9134983794646929,0.658370466660656,6,99942,101052,101041,1110,-11,2850
AGATCC,3.2382353295554798,0.0211173306948336,0.9186567734969542,0.658242568093219,6,100518,101045,101042,527,-3,2851
TAAACC,3.03475205772398,-0.0207787591901258,0.911631916966934,0.6559627318107379,6,100946,101054,101043,108,-11,2852
CGCTCT,2.62653929936761,-0.44765395227021904,0.938879124164428,0.65549615297979,6,101293,101010,101044,-283,34,2853
AGAGCG,2.62876729913192,0.89001704176558,0.938790536094562,0.6554633986656421,6,101292,101011,101045,-281,34,2854
CATAAG,3.03979190157,0.121225668925621,0.91069440299653,0.6554008371318399,6,100939,101055,101046,116,-9,2855
GGCTAC,3.19011886436359,0.136120432511204,0.923570270136468,0.654712444698911,6,100659,101038,101047,379,9,2856
GTATTG,2.8647419210370897,0.35875711866623794,0.912226138591315,0.653869326089765,6,101157,101053,101048,-104,-5,2857
CTTATG,3.03246917255309,0.112062556989665,0.906776298031712,0.652546039035162,6,100949,101059,101049,110,-10,2858
ACGCCT,2.99419874406725,-0.14560350187818802,0.9251381369288578,0.652415031265582,6,101003,101034,101050,31,16,2859
AGGCGT,2.99346150843673,-0.146230906822451,0.924703695415504,0.652173042144406,6,101005,101035,101051,30,16,2860
CAATAC,2.8647596301910094,0.348977525983269,0.9085364295759709,0.6510762282931291,6,101156,101057,101052,-99,-5,2861
CTAAGA,3.23110830962525,0.0585530645996766,0.899688520285377,0.6503769852287989,6,100543,101062,101053,519,-9,2862
GTAGCC,3.18298823861342,0.12496736168414199,0.9164185154795469,0.649522135775256,6,100673,101049,101054,376,5,2863
CTATAA,3.10876473273277,0.325308528142372,0.8927428504633441,0.649145032281318,6,100805,101069,101055,264,-14,2864
ATCACG,2.36681060196252,0.6515573355564561,0.9246313731988349,0.647701317306168,6,101397,101036,101056,-361,20,2865
TATTAG,2.95385418945136,0.0641872837636424,0.8931290240200709,0.647242885073975,6,101049,101067,101057,18,-10,2866
CTAATA,2.95108241676817,0.0621108412540092,0.893130646207645,0.647133886159287,6,101054,101066,101058,12,-8,2867
TAGGTC,2.90553487074104,0.115529388583923,0.909910694345813,0.6466729520215171,6,101109,101056,101059,-53,3,2868
TCTTAG,3.2255451183722,0.0388955125127932,0.8929135213855749,0.645471497343884,6,100560,101068,101060,508,-8,2869
GGTTTA,3.0203174981626497,-0.0309366952892081,0.895906179475864,0.644571756808173,6,100965,101064,101061,99,-3,2870
CTAGAG,3.4289079634370796,0.0545057165672436,0.895101112798141,0.644334424646318,6,100069,101065,101062,996,-3,2871
TTATAG,3.10358308691711,0.325549910603396,0.8847878097769258,0.64335419600205,6,100817,101079,101063,262,-16,2872
GATGTC,3.13450102777518,0.36277169432981393,0.8997421854878609,0.6431286765703179,6,100767,101061,101064,294,3,2873
CGCCCT,2.68277272496872,-0.5318377344242671,0.9299441795690251,0.643115862160914,6,101263,101027,101065,-236,38,2874
GACGGA,2.51320261329985,-0.225097173388992,0.9235384547134692,0.6426953887104111,6,101340,101039,101066,-301,27,2875
AACTAC,3.05690948469823,0.47426171130700107,0.8924353473192049,0.642487066530133,6,100907,101070,101067,163,-3,2876
GACCTA,2.9005604469685093,0.371890898526235,0.903050760325357,0.641638066152626,6,101116,101060,101068,-56,8,2877
GATACT,2.82262528350574,0.393514000009887,0.8902839670591051,0.637414770948315,6,101193,101071,101069,-122,-2,2878
GTAGAC,2.7699973579486095,0.141562319246804,0.8983821207614909,0.636209804276446,6,101213,101063,101070,-150,7,2879
ACTTAG,3.05020892313261,0.18717926581833802,0.882961390882832,0.6356367767758879,6,100919,101081,101071,162,-10,2880
CATACC,3.0819784029819703,0.34641558126857896,0.888870828129068,0.634423458098594,6,100856,101075,101072,219,-3,2881
TGAATC,3.23682792568931,0.292295434936557,0.876458629288097,0.633704507442698,6,100523,101089,101073,566,-16,2882
AGCCCG,2.67017093523186,0.33807263058097803,0.91618409591508,0.633358979128193,6,101271,101050,101074,-221,24,2883
GGTCCA,3.35351241127202,0.0722941124257108,0.888822327887713,0.6327182751732341,6,100257,101076,101075,819,-1,2884
AGCTAA,3.3679125450231804,0.275309957059523,0.872493997976823,0.632688342777312,6,100210,101094,101076,884,-18,2885
TGTTAC,3.07444319141045,0.34153723848592,0.8778428587924141,0.632350332510044,6,100877,101087,101077,210,-10,2886
GGATCC,3.27327413189988,0.0496987474121067,0.8900094225858459,0.6322727729171321,6,100434,101073,101078,639,5,2887
CTATGG,3.1997205965679902,0.0940842859939117,0.881624257450476,0.6311872103667121,6,100639,101082,101079,443,-3,2888
GTCTAC,2.7602063199015294,0.144127641370245,0.889749376631503,0.629941409512679,6,101221,101074,101080,-147,6,2889
AGAACC,3.43462422316683,0.039024712896837996,0.8740373059239591,0.629186673700085,6,100054,101092,101081,1038,-11,2890
GTAACA,3.06876309076074,0.329995974930593,0.8729926169956229,0.6286977172445251,6,100888,101093,101082,205,-11,2891
GATTCA,3.23524495112606,0.28201648757215003,0.869452636412165,0.628616180886698,6,100527,101100,101083,573,-17,2892
CGGGCT,2.66088796542962,-0.6055378464614499,0.9083833430538539,0.627877757351751,6,101275,101058,101084,-217,26,2893
GGTATG,3.06869997934285,0.34260600714704403,0.8781626576488829,0.6267164599288829,6,100889,101086,101085,197,-1,2894
CCGGCC,3.6167416063620097,0.11605142141260302,0.8900701559916121,0.625319004709662,6,99584,101072,101086,1488,14,2895
GGCCGG,3.61508542018202,0.11471915825654101,0.88873789283555,0.624430412327518,6,99586,101077,101087,1491,10,2896
CTAAGT,3.0306025488170403,0.167529750345462,0.8675894994722719,0.624281052059693,6,100953,101102,101088,149,-14,2897
GGATAA,3.14605591472958,0.297755262966593,0.8651895852875631,0.624239760602729,6,100742,101106,101089,364,-17,2898
TAGACC,2.87521178288165,-0.032293640469776,0.877702096238499,0.623223451539943,6,101150,101088,101090,-62,2,2899
GCAACT,3.2315163793067403,0.258013581201805,0.869899666093611,0.623204707752709,6,100542,101098,101091,556,-7,2900
GGTTCT,3.4259980057390695,0.0339995279167624,0.8652782044835471,0.6228983789072221,6,100070,101105,101092,1035,-13,2901
TTAGCT,3.35605795346811,0.261840264550788,0.859024305468088,0.622824755013172,6,100249,101122,101093,873,-29,2902
GGATAC,2.86444894964203,0.31369747880000703,0.87613872627475,0.621975810196334,6,101158,101090,101094,-68,4,2903
ATAAGG,3.13948922661192,0.234174497557985,0.8586228971699069,0.6194067842538941,6,100755,101123,101095,368,-28,2904
CCTTAT,3.141264689626,0.23574499250884498,0.858459336206389,0.619323995426443,6,100750,101124,101096,374,-28,2905
GTAGTT,3.0258768785689902,0.43935607438309005,0.860090434353465,0.618884616900419,6,100959,101119,101097,160,-22,2906
TTATCC,3.1399105932782696,0.29786734068513004,0.85710523985866,0.6183269350462729,6,100754,101125,101098,371,-27,2907
AGTACT,2.95618991731166,0.358470028688128,0.859849843158543,0.617616765604728,6,101043,101120,101099,77,-21,2908
GTATCC,2.8571475144329,0.31075215594575706,0.8699744560759549,0.617490129506565,6,101164,101097,101100,-67,3,2909
CTCGTG,2.60189326421199,-0.6767079581552939,0.8837219947234659,0.61659605463251,6,101304,101080,101101,-224,21,2910
GGAACC,3.4875601010899104,0.155798837707668,0.863287030591538,0.6165677810068989,6,99916,101109,101102,1193,-7,2911
GGTCTA,2.8635502413807004,0.119155987604875,0.867926064985477,0.616172364031043,6,101159,101101,101103,-58,2,2912
CCCTAG,3.46074758339059,0.097889186736646,0.862930656472217,0.6159065848321371,6,99979,101110,101104,1131,-6,2913
CGGGAT,2.4750959435999,-0.539418123201898,0.8854317850135199,0.615543009220192,6,101357,101078,101105,-279,27,2914
AACTAT,3.0633945888945604,0.514986199742808,0.8473727066251321,0.615532958472216,6,100896,101134,101106,238,-28,2915
ATAGTG,3.1376192048846603,0.25016009167250897,0.852697924737305,0.615141887595087,6,100759,101129,101107,370,-22,2916
CTAGGG,3.4592409494610696,0.106728140691832,0.8617479455666199,0.615107313847467,6,99982,101114,101108,1132,-6,2917
ATAGTT,3.0643295354977598,0.5293696133344129,0.845534258357574,0.614275371080927,6,100895,101136,101109,241,-27,2918
CACGAG,2.60194898936284,-0.672348311373872,0.8803730958222249,0.614173111805535,6,101303,101083,101110,-220,27,2919
CCCCGC,3.40795714726735,0.0526992877331995,0.878773683985683,0.6137801378993629,6,100125,101085,101111,960,26,2920
CCTCGG,3.36743833041204,-0.251497574781471,0.870337301251556,0.61367646788339,6,100213,101096,101112,883,16,2921
GTAAGG,3.0870492845493196,0.24976127032352802,0.8591917880319642,0.613418978064124,6,100850,101121,101113,271,-8,2922
CACTAT,3.13413289208427,0.244510860961272,0.8481235757189879,0.6117297512354871,6,100768,101132,101114,364,-18,2923
AGTTGC,3.2180229112354906,0.25035597757581,0.853632803151601,0.6114211249776489,6,100590,101127,101115,537,-12,2924
GCGGGG,3.40298320233819,0.0570687768910805,0.8744475851043759,0.6108255413962861,6,100135,101091,101116,956,25,2925
CCATAG,3.1731472068652002,0.0660451226255123,0.853568650806665,0.610633435859234,6,100692,101128,101117,436,-11,2926
AGACGG,3.12994803685457,0.10542134719567801,0.8622411487103661,0.610275798868059,6,100774,101112,101118,338,6,2927
GTAACT,3.0104571455216096,0.479093252247489,0.8474440961768491,0.609494095578139,6,100982,101133,101119,151,-14,2928
GGTCAA,3.24474413304052,0.27799354309757596,0.8500414837520601,0.609206310375379,6,100499,101131,101120,632,-11,2929
CCGAGG,3.36094576656777,-0.257726159071058,0.8622831501832859,0.607887228252875,6,100233,101111,101121,878,10,2930
GGTTCC,3.4771256228861405,0.15745346353283202,0.851237451434098,0.607879550052693,6,99939,101130,101122,1191,-8,2931
TGATAG,3.1252789820418196,0.332748344529868,0.84035770189446,0.606064948597396,6,100788,101144,101123,356,-21,2932
TCCGTC,2.45803449171676,-0.26479426678096396,0.869607997330462,0.604209131541894,6,101362,101099,101124,-263,25,2933
GCCGTG,2.65401283604089,-0.6370663775194211,0.8706731963558509,0.601690409553824,6,101280,101095,101125,-185,30,2934
CCTTAC,3.07330757091449,0.223009876706858,0.8420499623852751,0.600913435409266,6,100879,101139,101126,260,-13,2935
CGTGGA,2.42020832267441,-0.665906894943264,0.8648775169752858,0.600294912846817,6,101373,101107,101127,-266,20,2936
CGCTTG,2.57894222094971,-0.291555020658773,0.8607709514611891,0.6001887820915861,6,101311,101117,101128,-194,11,2937
GTAGTG,3.07263163418817,0.238181353900677,0.8407191869654721,0.6000520585978101,6,100882,101142,101129,260,-13,2938
TCAACC,3.2325155663559504,0.265441053389077,0.837488994043563,0.5999675853831969,6,100539,101146,101130,607,-16,2939
CACTAC,3.07511454238127,0.23704025614867602,0.840652970906394,0.599905457191129,6,100873,101143,101131,270,-12,2940
TTAGAG,3.3254445654623503,-0.0133427726856574,0.8272526235452379,0.599369239967847,6,100319,101161,101132,842,-29,2941
AGCGGG,2.62091537585452,-0.701397203610235,0.867252459561666,0.5987260944337679,6,101296,101103,101133,-193,30,2942
GGTATC,2.83901608006922,0.353801203744446,0.843391903673998,0.5983757123939879,6,101174,101138,101134,-36,-4,2943
CGCCGC,2.5004462138378303,0.378248041019134,0.8802612083542679,0.59813780891911,6,101347,101084,101135,-263,51,2944
CGCAGG,2.6505977360048596,-0.9394355151574699,0.865335689208742,0.5978962794811651,6,101281,101104,101136,-177,32,2945
GTAAGC,2.8713960064861697,0.259801782796785,0.841026497057534,0.59715593172344,6,101152,101141,101137,-11,-4,2946
GATACC,2.8390178347340296,0.349464397296364,0.8415081480908779,0.596967480967522,6,101173,101140,101138,-33,-2,2947
GATCAA,2.9955579277936604,0.256492248812695,0.8285401894671801,0.59565064915691,6,100999,101160,101139,161,-21,2948
CACGGC,2.64717386393741,-0.639394704442699,0.8619118171412871,0.5954294670333671,6,101284,101113,101140,-171,27,2949
CCTGCG,2.64499042045304,0.583457386331499,0.861650780767999,0.5952550662315661,6,101286,101115,101141,-171,26,2950
GGTTGA,3.22820426836469,0.254168909757571,0.830324930898552,0.594905766510804,6,100553,101156,101142,603,-14,2951
CCCGCT,2.61410041767749,-0.707414575170068,0.8612718722777991,0.5944028419783779,6,101299,101116,101143,-183,27,2952
CCCGTG,2.64366063302304,-0.74734516350002,0.860320993337997,0.5943138989620921,6,101288,101118,101144,-170,26,2953
TTGACC,3.22753025700479,0.253170975373749,0.829326996514729,0.594116670427088,6,100555,101159,101145,604,-14,2954
TTGATC,2.9949273360357602,0.25013847561463004,0.8262944967556121,0.59409894781194,6,101001,101162,101146,161,-16,2955
GGCTAG,3.43023571049631,0.0452928689766008,0.832742706601865,0.593975245147527,6,100067,101153,101147,1086,-6,2956
GCTTAC,2.8684907335958796,0.258850709098784,0.8350450351793108,0.592869536431116,6,101154,101151,101148,-3,-3,2957
AACACC,3.41611174098255,0.13166861368944,0.823925693236422,0.592822412893412,6,100100,101164,101149,1064,-15,2958
ACCGTG,2.6291534819245297,-0.27265949775024695,0.8458138422394941,0.5905597907675799,6,101291,101135,101150,-156,15,2959
CACGGG,2.63996640663613,-0.743187844465725,0.854704359840014,0.59036484836365,6,101289,101126,101151,-163,25,2960
CACGGT,2.63053597062399,-0.26425687829019,0.8452739238278679,0.590205484182433,6,101290,101137,101152,-153,15,2961
CTCTAA,3.30730405823479,-0.0242651487302865,0.813043805105522,0.588772964771713,6,100362,101174,101153,812,-21,2962
GGTGTT,3.40877051868451,0.128613729109754,0.817539623143636,0.588323302197951,6,100122,101169,101154,1047,-15,2963
CATTGG,3.41062365553903,0.214199695378284,0.817146429863158,0.5880005636723621,6,100116,101170,101155,1054,-15,2964
GCGGCG,2.48469475652667,0.37383691785415796,0.8648336740670359,0.587430024758122,6,101353,101108,101156,-245,48,2965
CCGTCT,3.09564698774331,0.0846138232652596,0.8302355585265191,0.587103003927525,6,100834,101157,101157,323,0,2966
GGTGTA,3.01399843796665,0.13453522223880499,0.823461116272688,0.586874545206866,6,100976,101165,101158,189,-7,2967
ACGGGG,3.1672445283151003,0.0184726787020946,0.83585148691539,0.5861979960069921,6,100697,101148,101159,451,11,2968
AACCTT,3.3324823292353902,0.189628528953026,0.808668614631442,0.585939585930903,6,100297,101177,101160,880,-17,2969
AGATCG,2.3602818835321604,1.10829724829772,0.835865465425288,0.5854495647156639,6,101400,101147,101161,-253,14,2970
TACACC,3.0143569734111297,0.12899231901125302,0.821249398558235,0.5851692943876899,6,100975,101167,101162,192,-5,2971
CGATCT,2.35997610458571,-0.19032442312626,0.835156393171927,0.5849552655704361,6,101401,101150,101163,-251,13,2972
CTGTCG,2.39405389034175,0.74857294300732,0.840284671866627,0.5827838650364741,6,101388,101145,101164,-243,19,2973
CGGGTT,2.55225124854517,-0.36621170594137104,0.835361534891225,0.582067306230257,6,101320,101149,101165,-171,16,2974
GTAATG,3.00139154661442,0.303085913502144,0.8078674029843141,0.5809352126219289,6,100993,101179,101166,186,-13,2975
GGTACC,3.04737220900299,0.406618862169033,0.8221776113978458,0.580660077430557,6,100923,101166,101167,243,1,2976
AACTTG,3.3249224885219197,0.26990304810564,0.8001511411073171,0.579697527551807,6,100321,101183,101168,862,-15,2977
AACGGG,2.5468192240988303,-0.456470492405034,0.8315446113985608,0.579234721118188,6,101324,101154,101169,-170,15,2978
CCCCGT,3.1566962024398304,4.2006774041425394e-05,0.8261164030265251,0.579135297975236,6,100719,101163,101170,444,7,2979
CAAGTT,3.3284031742497198,0.26189790704452803,0.798612101829352,0.578628367202371,6,100308,101184,101171,876,-13,2980
CCAATG,3.39434640993217,0.20501484682666196,0.80440669232105,0.578544704494764,6,100152,101182,101172,1030,-10,2981
ATAACT,3.0130624264580796,0.229606221867678,0.7970405441886509,0.5783191655342421,6,100977,101186,101173,209,-13,2982
CTAGCC,3.4061660335872204,0.0168979528734461,0.808349106668851,0.576164344431879,6,100128,101178,101174,1050,-4,2983
CTGGCG,2.58675489570911,0.34325351712046104,0.8342502733333391,0.575356198158917,6,101308,101152,101175,-156,23,2984
CTTTAG,3.29168539366193,0.0290972008049462,0.794651745661907,0.575311245900212,6,100395,101189,101176,794,-13,2985
CGACAG,2.38708461011765,-0.8294317046748909,0.8295074742835171,0.5751060953170971,6,101391,101158,101177,-233,19,2986
CTATCA,3.08198315462352,0.294557107765211,0.7959738382582429,0.5734138255135699,6,100855,101187,101178,332,-9,2987
GGCGAG,2.58424575372575,-0.822809734767338,0.8305828374328871,0.5727768737278199,6,101309,101155,101179,-154,24,2988
AGTTAT,3.00678041380185,0.228747237488131,0.7879851366616608,0.571728444307884,6,100986,101196,101180,210,-16,2989
CAATAG,3.0807111592759298,0.381486992811919,0.7935435489935649,0.571642404962971,6,100861,101190,101181,329,-9,2990
CTATTG,3.07210336514166,0.375242032444206,0.788340378911387,0.567846528640342,6,100883,101194,101182,311,-12,2991
CTAAAC,2.9544571750396496,-0.0443329075432875,0.789983037660624,0.567344759442545,6,101046,101193,101183,147,-10,2992
CATTAC,2.9870704556185697,0.27855512560522305,0.788223792865521,0.566557011613083,6,101015,101195,101184,180,-11,2993
CGCCAG,2.57482827682282,-1.00966141508537,0.820841437506033,0.565824891706934,6,101313,101168,101185,-145,17,2994
ACCCGG,3.13887459679372,0.0156965697850833,0.8071576323700799,0.565561184081937,6,100756,101180,101186,424,6,2995
CCGGGT,3.1369904141486096,0.0199948053425221,0.806734537759237,0.565308901599966,6,100761,101181,101187,420,6,2996
TGCTAG,3.34915365671507,0.13850202290182198,0.785994005707872,0.564757178008124,6,100269,101198,101188,929,-10,2997
TCCACG,2.3689530472186098,0.303361553350824,0.8129374986084751,0.563321808079416,6,101396,101175,101189,-221,14,2998
CGTTGG,2.5256298873995804,-0.34119140133201303,0.808740173745635,0.5630875323635219,6,101335,101176,101190,-159,14,2999
CTCGCC,2.56591103454145,-0.845874818499867,0.813082489141758,0.5603293835298921,6,101314,101173,101191,-141,18,3000
GTTTAG,2.94563015171694,-0.0393117494543933,0.7798437075014191,0.5600710269795479,6,101065,101200,101192,135,-8,3001
AGTTAC,2.9462124395763998,0.42108973935900107,0.7789649073266209,0.559384332635164,6,101063,101201,101193,138,-8,3002
GGGACG,2.4044579820711602,0.5713802981817939,0.814793823484784,0.558792169969048,6,101382,101171,101194,-211,23,3003
CGTCCC,2.40307408945823,-0.6118833567891571,0.814647595071936,0.558601229382229,6,101383,101172,101195,-211,23,3004
CTAGCT,3.3088704865938596,0.17903788895469896,0.776221929872001,0.5571683130842231,6,100359,101203,101196,844,-7,3005
TGTTAA,3.25207543306992,0.22661337407065,0.762918994377145,0.556551996629507,6,100479,101218,101197,739,-21,3006
CTAAAG,3.2630212738331603,0.0170482744135843,0.767602726786803,0.555300780225702,6,100454,101214,101198,760,-16,3007
TTAACA,3.2510051284922303,0.21660571759941397,0.7596023596644409,0.554062536201521,6,100484,101220,101199,736,-21,3008
CCCTAT,3.0932491105274504,0.0097873786504401,0.774828848386008,0.553215984799788,6,100836,101204,101200,368,-4,3009
TGCTAA,3.2873183202174503,0.11505498999679599,0.7625469728028481,0.551981245302866,6,100406,101219,101201,813,-18,3010
ATAGGG,3.0922059798319306,0.0179315419225343,0.772951346797322,0.551918221228311,6,100837,101208,101202,371,-6,3011
GTCTAG,2.9759330229794503,0.0289099347808293,0.7745316700420891,0.5514429636906729,6,101023,101205,101203,182,-2,3012
CCCTAA,3.3273851065963,0.00291501353494894,0.7679564832705191,0.5514174642960551,6,100313,101213,101204,900,-9,3013
GGCTAT,3.08982088927935,-0.0157252874634377,0.771724550161828,0.5510140763119901,6,100844,101210,101205,366,-5,3014
GATTGG,3.16666961323423,0.19973024393312902,0.768790275768097,0.5499899940843139,6,100698,101212,101206,514,-6,3015
CCCTCG,2.5506601942889904,0.546022429564024,0.7978316488892908,0.5495613689995901,6,101321,101185,101207,-136,22,3016
ATAGCC,3.08908016416322,-0.0219495456907204,0.7695016081046852,0.549351910242146,6,100846,101211,101208,365,-3,3017
AGCTAG,3.29931290824283,0.168322016686592,0.765506057603893,0.5493460408440499,6,100380,101215,101209,835,-6,3018
CATTAA,3.24449897629205,0.243427540203971,0.753096207464267,0.5492392084019471,6,100501,101227,101210,726,-17,3019
CGTCTG,2.34607805846488,-0.600891793962923,0.792308839989754,0.548732671625963,6,101409,101191,101211,-218,20,3020
CGCTCC,2.54772871545826,-0.597929781445712,0.7949001700585671,0.547496887537963,6,101323,101188,101212,-135,24,3021
TTAGCA,3.28603644739318,0.0963984947843617,0.756245374972812,0.547403859646083,6,100408,101222,101213,814,-9,3022
CAGACG,2.34774610439695,0.5981752806642379,0.7901689685628102,0.54719869699888,6,101407,101192,101214,-215,22,3023
TTAATG,3.23754196272668,0.243604034551732,0.7483855240339009,0.5457771528008171,6,100520,101232,101215,712,-17,3024
CTAGAT,3.01170526432833,0.16336292911399403,0.7572950784663209,0.544673663298752,6,100980,101221,101216,241,-5,3025
ACGTGG,2.7130514232316,-0.350794481087016,0.777750032788978,0.5443510202668571,6,101245,101202,101217,-43,15,3026
TTAGGG,3.31800340824363,0.0011055081962236802,0.756125313071012,0.5429200478182961,6,100336,101223,101218,887,-5,3027
CGAGGG,2.5410424907168503,-0.8934370702928192,0.7873795744239871,0.542269012949521,6,101329,101197,101219,-132,22,3028
ATCTAG,3.00766158716452,0.152428071286376,0.7532514013025121,0.541712890865659,6,100984,101226,101220,242,-6,3029
AGGGCG,2.53883254506604,0.0778761495763423,0.7851696287731841,0.540712405254443,6,101331,101199,101221,-132,22,3030
CTAACA,3.27036704451393,0.20035272489928196,0.7433493669643121,0.5378182688217249,6,100438,101236,101222,798,-14,3031
AACCCG,2.48898531846333,0.273099241371474,0.773386782739136,0.5377590973704339,6,101352,101206,101223,-146,17,3032
CGAGTA,2.0256216892484598,-0.3585268918354029,0.773111702696928,0.536352691573511,6,101571,101207,101224,-364,17,3033
TACTCG,2.02358630479732,0.7271181981145319,0.77223461216288,0.535717057586956,6,101574,101209,101225,-365,16,3034
CCAATC,3.14342518653848,0.18572494622825,0.7483986142260991,0.534976450943535,6,100745,101231,101226,486,-5,3035
CTAGCA,3.31058793542427,0.0853350740936207,0.745181954282071,0.534877396931287,6,100352,101234,101227,882,-7,3036
GGATAG,3.0685859866362204,0.23633623281514302,0.7493313536016141,0.534738016246491,6,100891,101229,101228,338,-1,3037
AGTACC,2.91204657468408,0.249158315864031,0.750538130334444,0.5334309537937261,6,101103,101228,101229,125,1,3038
ATCTAA,2.95102904215846,0.134183829872901,0.735007159889037,0.532562152026433,6,101055,101243,101230,188,-13,3039
CTATAC,2.66680622310023,0.19896357745557602,0.743340446905538,0.5301343628962399,6,101273,101237,101231,-36,-6,3040
GGTACT,2.90493881660168,0.24814262214383698,0.744912589193055,0.529400851706073,6,101110,101235,101232,125,-3,3041
TTAGAT,2.94902185123709,0.136294424744577,0.7302265740969021,0.529130920478094,6,101057,101248,101233,191,-15,3042
TCAATC,2.90101786460549,0.163513772848539,0.7355617135030229,0.527614197711783,6,101115,101242,101234,127,-8,3043
CCACGT,2.6893669227086097,-0.364784853795085,0.7537416092420679,0.527133975200661,6,101260,101224,101235,-36,11,3044
CTAAGC,3.09958883626419,0.15674740879031301,0.737972123051064,0.526980388072384,6,100825,101240,101236,415,-4,3045
AGGCGC,3.0208613618119706,-0.31743471731556894,0.753499884922386,0.526257507372064,6,100963,101225,101237,262,12,3046
GATTGA,2.9024131336362897,0.156062685991156,0.7322187071321359,0.525289882012576,6,101114,101245,101238,131,-7,3047
GTATAG,2.65968334647479,0.18305134447219398,0.7365203643972701,0.525234934677475,6,101276,101241,101239,-35,-2,3048
GCTTAG,3.09938939631552,0.15880496215110002,0.734999288231629,0.524915646424799,6,100826,101244,101240,418,-4,3049
CCCGAC,2.35514433659027,-0.578624991729329,0.765156254979967,0.5238320387114029,6,101404,101216,101241,-188,25,3050
AAGGTT,3.2473080624367405,0.114387753148277,0.7238182708567141,0.523494028290235,6,100495,101252,101242,757,-10,3051
GTCGGG,2.35178042334529,-0.57031097490381,0.7636778519829158,0.522917944446551,6,101405,101217,101243,-188,26,3052
GCGCCT,3.01483408882756,-0.322110732951986,0.748630905855061,0.5227748588066571,6,100973,101230,101244,257,14,3053
CCCGCA,2.5335928064630697,-0.8212455311696709,0.748006836643022,0.5149316237995191,6,101333,101233,101245,-100,12,3054
ACTGCG,2.29787869048311,0.575903484348871,0.742862055196065,0.513712532702219,6,101427,101238,101246,-189,8,3055
AACTAA,3.16003588781993,0.370619137483846,0.70300564436617,0.5117319805534,6,100713,101263,101247,550,-16,3056
TGTGCG,2.48059950816927,0.755037566694057,0.731917144395405,0.508940083684298,6,101356,101246,101248,-110,2,3057
CTATCC,3.03197937542164,0.222455353979031,0.7135591132801979,0.508692705427831,6,100951,101256,101249,305,-7,3058
GCCGCT,2.49200185580596,-0.72958655407886,0.73917331040626,0.5082758765644511,6,101351,101239,101250,-112,11,3059
CGGAGT,2.48338143801233,-0.609062448899595,0.7297185217194749,0.5074151724870879,6,101355,101249,101251,-106,2,3060
GCCTAA,3.0708768154414905,-0.361481536578683,0.7092601022283629,0.506115778718206,6,100885,101257,101252,372,-5,3061
CCTTAG,3.2668242085256898,0.0855821046507312,0.704622190329147,0.505261220569312,6,100443,101261,101253,818,-8,3062
AATTGG,3.2222393958058597,0.0951358781833704,0.698749604225839,0.505072295817194,6,100574,101266,101254,692,-12,3063
TGTTAG,3.2259321168711,0.16208175427923902,0.6983873745857351,0.5048823430527439,6,100559,101267,101255,708,-12,3064
TTAGGC,3.07000042061081,-0.365324289711035,0.70561031252692,0.5035591103659129,6,100887,101260,101256,373,-4,3065
CCAATT,3.22047173761855,0.09313823315883599,0.696658023014598,0.503488532689671,6,100577,101268,101257,691,-11,3066
CCCGGA,2.54840139956384,-0.8802460689652369,0.7307284069915531,0.503302327799049,6,101322,101247,101258,-75,11,3067
ACGCCC,2.85258913119231,-0.197731877411243,0.7183601538573999,0.499242328239912,6,101166,101254,101259,88,5,3068
TCCGGG,2.54183985584256,-0.87139562598605,0.7241668632702701,0.498753929060456,6,101328,101251,101260,-77,9,3069
TCCCGG,3.20602902105438,-0.328868836843293,0.7089279918939051,0.49768888803711103,6,100626,101258,101261,632,3,3070
TGCGGG,2.5059944524488,-0.83789995399777,0.722978735787688,0.497423459358233,6,101343,101253,101262,-90,9,3071
GCACGT,2.45202937031037,-0.23349948899667103,0.714215966956472,0.49615235899020704,6,101363,101255,101263,-108,8,3072
CTAAGG,3.2509376793313303,0.0824024613210366,0.691832979029472,0.49589640495002896,6,100485,101273,101264,788,-9,3073
TTAAGG,3.2082030297740696,0.0752827204856104,0.684713238194048,0.494766025053327,6,100617,101277,101265,660,-12,3074
CGGCCG,2.5439364856512903,0.190674775465904,0.726263493079006,0.494224554050745,6,101325,101250,101266,-75,16,3075
CCGGGA,3.20101260534327,-0.332885438246118,0.702349988958789,0.492997713448314,6,100636,101264,101267,628,3,3076
CCTTAA,3.20410554801033,0.0612517477279653,0.680291833406381,0.49147491322498604,6,100630,101281,101268,651,-13,3077
ACTCCG,2.4589077303165,0.507519481723376,0.7060791849168101,0.49056487358986794,6,101361,101259,101269,-102,10,3078
TTAGAC,2.85085525514211,-0.0732120786223565,0.683607722892333,0.4897787816962171,6,101167,101278,101270,111,-8,3079
GGGCGT,2.8363667845287504,-0.205271337610268,0.703922818252019,0.489109434301786,6,101178,101262,101271,84,9,3080
TTAGTT,3.13236130295613,0.354777918654779,0.6709425636779399,0.488199257411777,6,100769,101287,101272,518,-15,3081
GACTAT,2.7717098237570603,0.317417394446748,0.6812983956015269,0.487179531545254,6,101211,101279,101273,68,-6,3082
CTCCGC,3.15809243284517,-0.290598221653482,0.694077339760021,0.486591860869248,6,100714,101271,101274,557,3,3083
CCTTCG,2.4181352114085497,0.873703390954182,0.7009215747306841,0.4864372700339121,6,101374,101265,101275,-109,10,3084
ACGTGT,2.2346619007930295,-0.448547283220433,0.6954521613074979,0.48542443922497,6,101458,101269,101276,-189,7,3085
TTAACT,3.12490146264485,0.333869611355091,0.666256118237415,0.48465865488333293,6,100789,101291,101277,502,-14,3086
ATAGTC,2.76740994799765,0.30666748392185306,0.6774018131490289,0.48434271444131105,6,101216,101282,101278,66,-4,3087
GCGGAG,3.1545761086915296,-0.29405470378000104,0.68972664471322,0.483549200294395,6,100722,101275,101279,553,4,3088
ACACGT,2.2335430190448,-0.448633799830871,0.692872191525007,0.48354517458799195,6,101460,101272,101280,-188,8,3089
TGCGTG,2.4439951776067597,-0.6725974594929589,0.6953128138328941,0.482973840890346,6,101365,101270,101281,-95,11,3090
TTAAGC,2.99535693262268,0.0881304138706369,0.669355128131386,0.48123676740143895,6,101000,101289,101282,289,-7,3091
GCTTAA,2.99184540448971,0.0896492739178889,0.665843599998416,0.478672195385933,6,101008,101292,101283,284,-9,3092
CGCAGT,2.2468219904893796,-0.906106286544834,0.6906470612852441,0.47687473096659294,6,101446,101274,101284,-172,10,3093
AGCGCT,2.37420916581427,-0.6513108406281379,0.685390696694006,0.47504365211289296,6,101393,101276,101285,-117,9,3094
CAATTG,2.97333824786536,0.0723266080385745,0.6568178372147421,0.4719751668444,6,101027,101297,101286,270,-11,3095
AACTAG,3.14942022464633,0.321615170717651,0.654001677599975,0.471878894142992,6,100734,101298,101287,564,-11,3096
AGCGAT,2.2011034717737,-0.411772545842874,0.675125466442831,0.47075627991692,6,101487,101283,101288,-204,5,3097
CGAGGA,2.27050892806285,-1.05227808407296,0.680844769476469,0.4704382848444171,6,101436,101280,101289,-156,9,3098
AGTTAA,3.1066459572511502,0.326318662989296,0.646842318926629,0.470342974042219,6,100808,101299,101290,491,-9,3099
GGCCGA,3.16866738222909,-0.10401396873440301,0.670004765844604,0.46987721646396,6,100694,101288,101291,594,3,3100
TCGGCC,3.16599660415115,-0.105123159588342,0.668895574990668,0.46906798820807705,6,100700,101290,101292,590,2,3101
CACGCA,2.42799415826456,-0.691690864600128,0.67481913422068,0.468389500245516,6,101369,101284,101293,-85,9,3102
ATCGCT,2.1942514214196502,-0.406851527566896,0.670993297229868,0.4677880604123571,6,101494,101286,101294,-208,8,3103
TCCTCG,2.26127662712605,0.25663886240109,0.6728501327397521,0.46479467103262295,6,101439,101285,101295,-154,10,3104
GACGTG,2.22101717354484,-0.479640941137975,0.665686367845712,0.459316302936746,6,101471,101293,101296,-178,3,3105
ACGTGC,2.3994749046060297,-0.29100184678550395,0.6616615012521351,0.45893753485093197,6,101385,101294,101297,-91,3,3106
CGGTGA,2.44319139708115,-0.6386329210033139,0.6601756804200369,0.45852171027548405,6,101366,101295,101298,-71,3,3107
CTATAG,2.8922148507339798,0.3362090535229231,0.6378046648719661,0.457420689067255,6,101126,101300,101299,174,-1,3108
GTCTAA,2.800668045238,-0.107966739368027,0.6376549958932309,0.45629565665308797,6,101202,101301,101300,99,-1,3109
TTAATC,2.92168204389742,0.294045290385791,0.627438750503387,0.45434403706406296,6,101095,101306,101301,211,-5,3110
CACGTC,2.2143026422297796,-0.478444885541194,0.65828709361965,0.454059133222062,6,101477,101296,101302,-181,6,3111
GATTAA,2.9199022018902796,0.28698662624737603,0.6240973212722359,0.45190318350268,6,101096,101307,101303,211,-4,3112
TGCACG,2.3848633062497497,0.4584239283932679,0.633934612340878,0.439516834230802,6,101392,101303,101304,-89,1,3113
ACAGCG,2.2219293532985898,0.47481491892928296,0.634155293591196,0.437507092703959,6,101469,101302,101305,-167,3,3114
CGGGAA,2.3464545730155,-0.966352902233169,0.6311799603152349,0.437109336314656,6,101408,101304,101306,-104,2,3115
CGCTGT,2.21550756672337,-0.817398728359558,0.629979837150984,0.434609542372356,6,101474,101305,101307,-169,2,3116
CCGAGA,2.88313733907597,-0.529070699599293,0.612159633653468,0.430406536047433,6,101137,101315,101308,178,-7,3117
CTAATG,3.1211954756892,0.0916426387924254,0.5964241282745971,0.43007744022463107,6,100791,101324,101309,533,-15,3118
TGGCGC,2.9130358327818398,-0.340377042598968,0.6163215555239979,0.429164043111913,6,101102,101311,101310,209,-1,3119
TCTCGG,2.8766703970815897,-0.54077750584851,0.609139789131021,0.428266803072623,6,101146,101318,101311,172,-7,3120
AGCGTG,2.33749216454121,-0.7575186455766941,0.6181626011356,0.42801202838344893,6,101412,101310,101312,-102,2,3121
TTCCCG,2.33321775119468,0.115716573149156,0.616004114516818,0.42643945214199797,6,101414,101312,101313,-102,1,3122
CACGCT,2.33573347579193,-0.750628202287579,0.615315876168403,0.425964571979161,6,101413,101313,101314,-100,1,3123
CATTAG,3.119879339674,0.0804195999933288,0.5900882672536271,0.425495798827015,6,100795,101332,101315,537,-17,3124
TCACCG,2.3987795605897997,0.541942880584131,0.6131935907697571,0.42528510008149795,6,101386,101314,101316,-72,2,3125
AGCGCC,2.37368110725993,-0.8545143335320109,0.619694267943146,0.42452254031456205,6,101394,101308,101317,-86,9,3126
AGCGGC,2.37321712451446,-0.8525097722285441,0.6195542082216059,0.42445099984114604,6,101395,101309,101318,-86,9,3127
GAATCG,2.09273106764529,0.9211529867236109,0.606702953131016,0.421731577765526,6,101540,101319,101319,-221,0,3128
CGAGCC,2.36534589778281,-1.00241104803346,0.6113590584660289,0.418704644072086,6,101398,101316,101320,-82,4,3129
TACTAG,2.68107111465293,0.0879610734505931,0.5847310404998111,0.417189736332875,6,101264,101335,101321,71,-14,3130
CGTTTC,2.08775264765471,-0.8132128302445741,0.6001094321867609,0.417119608909751,6,101542,101321,101322,-221,1,3131
GCGCCA,2.8964922835716003,-0.361267975689969,0.5975316761787521,0.41582427408196704,6,101120,101322,101323,202,1,3132
CACCGC,3.09064668010229,-0.0983829169501913,0.593874162596791,0.41553508017891494,6,100842,101328,101324,486,-4,3133
GGCTCG,2.3584151549764503,0.560794118552328,0.6059105326006761,0.414946061999998,6,101402,101320,101325,-82,5,3134
CTAGTA,2.67656752464592,0.0788476360223864,0.580227450492801,0.413929947198503,6,101267,101339,101326,72,-13,3135
CGATTC,2.08458423189697,-0.41506807774599397,0.595379429205016,0.413765335221703,6,101544,101326,101327,-218,1,3136
CGGCGG,2.42723463805327,-0.185927487176974,0.6098855685049089,0.413478844160892,6,101370,101317,101328,-53,11,3137
GCGGTG,3.08363650266536,-0.0994916557150916,0.589434238318791,0.412452551165582,6,100854,101333,101329,479,-4,3138
CTCGAA,2.24125063632147,-0.9579496144910079,0.590820470793798,0.412415617493841,6,101451,101331,101330,-120,-1,3139
CACTAA,3.09906092206236,-0.0315694702449694,0.572043244512749,0.412237086389287,6,100828,101347,101331,519,-16,3140
CGTGCA,2.3458427496902403,-0.6590751269075649,0.5949140557813649,0.411989360500992,6,101410,101327,101332,-83,5,3141
TACGTG,1.98104712644599,-0.532062672390005,0.592661972707713,0.41065841596263103,6,101602,101329,101333,-273,4,3142
CACGTA,1.98155846173898,-0.534755666021411,0.5923880658999521,0.410416143179975,6,101601,101330,101334,-271,4,3143
GGCGCT,2.34820872069142,-0.870911145144465,0.595704098315649,0.4078226034865379,6,101406,101325,101335,-81,10,3144
ACACGG,2.52109439241808,-0.557174077414679,0.584331913941199,0.406704708289029,6,101338,101336,101336,-2,0,3145
TTCGAG,2.23559386730969,-0.961205824314975,0.582390306911259,0.406518448354976,6,101456,101338,101337,-118,-1,3146
TTAGTG,3.09156672745841,-0.0385158478917536,0.5640219851730419,0.406475055006639,6,100838,101350,101338,512,-12,3147
CCGTGT,2.51760694764767,-0.560556722312555,0.5834427222153791,0.406104150127779,6,101339,101337,101339,-2,2,3148
CCGCCG,2.4152258057291203,0.3805205768934529,0.5972288901329069,0.40467335069794297,6,101376,101323,101340,-53,17,3149
CTAGTT,3.05542936483459,0.242231071811403,0.558395716834564,0.40205770511518607,6,100913,101356,101341,443,-15,3150
CGCAGA,2.13715740697881,-1.16024260790783,0.579580271144678,0.39882643398890794,6,101518,101340,101342,-178,2,3151
GTAACC,2.79091210482966,0.19437984135901898,0.562730685288381,0.39870555590413304,6,101208,101352,101343,144,-9,3152
GTCCCG,2.17379006212358,0.15832761354260902,0.58536356773728,0.39849055980158,6,101499,101334,101344,-165,10,3153
CGGATC,2.1662722262681697,-0.350144271481819,0.578169654905798,0.39824075411539794,6,101501,101342,101345,-159,3,3154
CGCTTT,2.22145271701068,-0.750105516361641,0.5694074505293311,0.397301987794248,6,101470,101349,101346,-121,-3,3155
GGTTAC,2.79114257626495,0.202333722792041,0.560208890759659,0.39696935704840897,6,101207,101355,101347,148,-8,3156
TCTGCG,2.12947594676918,0.399592683825814,0.574459311482135,0.395272758221789,6,101523,101343,101348,-180,5,3157
GATCCG,2.16297007687241,0.870330051949303,0.5729819952621079,0.39462692295925106,6,101503,101345,101349,-158,4,3158
ATAACC,2.8309787947454796,-0.0176457800414376,0.549788542279535,0.393666247354534,6,101183,101361,101350,178,-11,3159
GCGTGC,2.50439632038272,-0.38322300684292204,0.569440341194719,0.39173893918891795,6,101345,101348,101351,3,3,3160
GGTTAT,2.82918223624914,-0.012537093320076999,0.5467008058534509,0.39152832732099196,6,101186,101364,101352,178,-12,3161
CGGGAC,2.16231840300927,-0.846296135453173,0.572654244422889,0.38968957603191395,6,101506,101346,101353,-160,7,3162
GCCGCG,2.19903267816277,0.42395814364688894,0.578847672679212,0.389386846504249,6,101489,101341,101354,-148,13,3163
CGTGTC,2.11765502742542,-0.598935660081766,0.563885808950296,0.387854939038802,6,101527,101351,101355,-176,4,3164
GCGCCG,2.19369933218741,0.35680601346439506,0.5735143267038489,0.38572609332446395,6,101495,101344,101356,-151,12,3165
AGGACG,2.08693204422353,0.37366087215818,0.560954038892657,0.385442557311711,6,101543,101353,101357,-190,4,3166
TGCGGC,2.34329031149184,-0.904018412232977,0.560274594830732,0.383512272475359,6,101411,101354,101358,-57,4,3167
GACACG,2.1142118496289397,0.381124029847195,0.556634713794807,0.382767796503484,6,101529,101358,101359,-171,1,3168
ACTCGG,2.64765772206923,-0.31337564319489697,0.5455111788555039,0.38108319299180704,6,101283,101366,101360,83,-6,3169
CGTGAC,1.9454154356120301,-0.736484465849946,0.557030281873747,0.381061341571875,6,101623,101357,101361,-266,4,3170
CGTCCT,2.0739475486014802,-0.7420642949812671,0.550689424411694,0.37824305608644704,6,101547,101360,101362,-187,2,3171
CCGAGT,2.64402960017557,-0.298832068576688,0.541458634748178,0.37821373118987606,6,101287,101373,101363,86,-10,3172
GAAGCG,2.07496063229779,0.512471700010746,0.5489826269669179,0.377075418747311,6,101546,101362,101364,-184,2,3173
CCGTGC,2.67799455960775,-0.407436677730539,0.545226670307102,0.37703276554393395,6,101265,101367,101365,102,-2,3174
GCACGC,2.4844007625985496,-0.39973176057685206,0.547983695376292,0.376691351569972,6,101354,101363,101366,9,3,3175
GCACGG,2.67604772295967,-0.405572787304459,0.542142668648683,0.374873509645185,6,101268,101371,101367,103,-4,3176
CGCCTT,2.2592766264593904,-0.778637688538893,0.5420629897815189,0.37442531220840797,6,101440,101372,101368,-68,-4,3177
CGCGGG,2.1760926235658897,-0.14955670555660597,0.556231541106257,0.37390413311314896,6,101496,101359,101369,-137,10,3178
GCCGCA,2.33129242814254,-0.9236193265274559,0.545706458322492,0.37334061243433503,6,101415,101365,101370,-50,5,3179
AGTTAG,3.0160042823092903,0.201647695369013,0.5178123403921739,0.372486282855581,6,100971,101387,101371,416,-16,3180
GTCACG,1.93346676404223,0.21821349763615697,0.544296368203195,0.37220725273643607,6,101632,101368,101372,-264,4,3181
TCTTCG,2.05733517726803,0.507495854829212,0.5340770530782479,0.37089556311297706,6,101559,101377,101373,-182,-4,3182
TGCGGT,2.3182058605559,-0.537327143702992,0.535190143894784,0.3703782068132199,6,101421,101376,101374,-45,-2,3183
ACCGCA,2.3188493429154904,-0.546796177868972,0.533263373095448,0.3689471902785129,6,101420,101378,101375,-42,-3,3184
CGGCAC,2.32443212225198,-0.8198944869069391,0.539170075455862,0.36878881703713295,6,101416,101374,101376,-42,2,3185
CGCTTC,2.05856885619882,-0.8992251324663519,0.535310732009043,0.3675050713328571,6,101558,101375,101377,-183,2,3186
CACGTT,2.20993896408425,-0.555854233046405,0.525136273182548,0.366265240716514,6,101481,101382,101378,-99,-4,3187
AAGGCG,2.24543658012694,-0.08513505005357298,0.530161967426666,0.366045497496048,6,101448,101379,101379,-69,0,3188
CCCGCG,2.1632976922494502,0.288296574770824,0.543112686765891,0.36486861054111397,6,101502,101369,101380,-133,11,3189
CGCGGC,2.1626650339918996,0.28138911425623403,0.542803951532262,0.36468117329280103,6,101504,101370,101381,-134,11,3190
CTAGTC,2.8792163495768897,0.140235514641251,0.510969843868427,0.362881471559814,6,101143,101395,101382,252,-13,3191
CGGCTA,2.27711220769062,-0.38191674172089296,0.5246075853148521,0.362560611404456,6,101433,101383,101383,-50,0,3192
TTCGTT,2.13177722312046,-0.556518364898148,0.515346865360943,0.36252166759318705,6,101522,101391,101384,-131,-7,3193
TAGCCG,2.2764562548957,0.308686864440952,0.5224694155789199,0.361072986221636,6,101434,101384,101385,-50,1,3194
GACTAA,2.8353712763537997,0.140070485859155,0.503951487013932,0.36090339946607203,6,101180,101400,101386,220,-14,3195
TTAGTC,2.83620135481158,0.13283542859778,0.5035697578249549,0.36068153649026796,6,101179,101401,101387,222,-14,3196
CGTCAC,1.9165396029139,-0.780783385122229,0.527369207074866,0.360413595226489,6,101651,101380,101388,-271,8,3197
CGAGAG,2.21204851926638,-1.1579698102695701,0.52207175622903,0.360097728960266,6,101480,101385,101389,-95,4,3198
AACGTG,2.19722937491862,-0.578758572238389,0.516288115105601,0.359960829778215,6,101492,101388,101390,-104,2,3199
GACTAG,2.87632880721479,0.142639713127549,0.5065207142823259,0.359691999481742,6,101147,101399,101391,252,-8,3200
GTGCCG,2.3086311195971603,0.533856302172728,0.525291479912124,0.359170521267532,6,101424,101381,101392,-43,11,3201
TTCACG,2.19886252047685,0.338549145627541,0.514059829575153,0.358426796542812,6,101490,101392,101393,-98,1,3202
CGTGAA,2.19431392095849,-0.6971460599412641,0.513372661145475,0.357897669278204,6,101493,101394,101394,-99,0,3203
CTAACT,2.9918074846652996,0.165160724653713,0.497547231536037,0.35766574007457597,6,101009,101407,101395,398,-12,3204
GTGACG,1.90928818541655,0.48980547853095896,0.520903031678271,0.35596192756326295,6,101657,101386,101396,-271,10,3205
CTCTCG,2.20370677530457,0.446974706688721,0.516046600101396,0.355857519975522,6,101485,101389,101397,-96,8,3206
CACGGA,2.29878747274517,-0.89470668101586,0.513525425949046,0.355103370161141,6,101426,101393,101398,-33,5,3207
GGGCGA,2.81090671985183,-0.399138142282286,0.5100560135800021,0.354114903140094,6,101198,101396,101399,198,3,3208
TCGCCC,2.8071245700847696,-0.408580503255628,0.507511528013016,0.352267437469261,6,101200,101398,101400,198,2,3209
ACACGC,2.24816241715249,-0.632618065591538,0.508887925764338,0.35134127843567303,6,101445,101397,101401,-48,4,3210
ACGGGA,2.60660378838825,-0.532339769254385,0.5028956579505209,0.35090302097452203,6,101302,101402,101402,100,0,3211
AGCACG,2.22401124162861,0.326924664140385,0.502435348087998,0.346656409369473,6,101465,101403,101403,-62,0,3212
CGGCGC,2.13550681533959,-0.124422955053584,0.5156457328799521,0.346109653671801,6,101519,101390,101404,-129,14,3213
GTGCGT,2.2373537639267997,-0.451661899430475,0.501001448607164,0.34588119650802596,6,101454,101405,101405,-49,0,3214
TCAGCG,2.0890034454773603,0.341889011108055,0.5012293857699671,0.344429834835816,6,101541,101404,101406,-137,2,3215
TCCGTG,2.2811324540731603,-0.904801258408591,0.49779281438812395,0.344092904640197,6,101432,101406,101407,-26,1,3216
CCGTGG,2.8242711217021,-0.634529268563272,0.49401524531272395,0.34311719622317205,6,101190,101409,101408,219,-1,3217
CGTGCT,2.21481167247121,-0.792393562730434,0.49664040298268697,0.34261577332755,6,101476,101408,101409,-68,1,3218
AACACG,2.17415839635877,0.315460122463135,0.49097080641074703,0.342038533136781,6,101498,101412,101410,-86,-2,3219
CGTGTT,2.17284643391449,-0.606487165834398,0.490290073147801,0.34164461259484996,6,101500,101414,101411,-86,-3,3220
CTAGTG,3.04128344369425,-0.12441404037774001,0.478123792687057,0.34096940863696396,6,100935,101425,101412,490,-13,3221
GCGTGT,2.2295132601517595,-0.650838499695809,0.49316094483212297,0.340388628349038,6,101464,101410,101413,-54,3,3222
CCACGG,2.8209288667021095,-0.629314560758679,0.48921190227847294,0.3396987410263111,6,101195,101415,101414,220,-1,3223
TCTCCG,2.24347000847659,0.29208175988345897,0.49064146307689294,0.33874512098682896,6,101450,101413,101415,-37,2,3224
CACTAG,3.03880394519507,-0.130214750704852,0.47339796405286794,0.337538388557034,6,100941,101427,101416,486,-11,3225
CCGCCA,2.9799993049485898,-0.47557286442562796,0.48322678744309405,0.337062703431461,6,101020,101422,101417,402,-5,3226
ACCGGG,2.30882396277827,-0.820290786243366,0.491150970205981,0.335800085022067,6,101423,101411,101418,-12,7,3227
CGGAAG,2.2400054737694304,-1.17841027405341,0.48634255747657595,0.33573661223261797,6,101452,101417,101419,-35,2,3228
CTTCCG,2.23769062812017,0.529662800168946,0.48486208272047704,0.334698124027759,6,101453,101418,101420,-35,2,3229
ACCCGC,2.6166161422747405,-0.30907389764516496,0.482387164939832,0.332918328377151,6,101297,101423,101421,126,-2,3230
GCACCG,2.27021191390882,0.413375233903144,0.48462594408877097,0.33091092705034697,6,101437,101419,101422,-18,3,3231
CCCGGT,2.30151698837284,-0.82842917530939,0.483843995800553,0.330733297477907,6,101425,101420,101423,-5,3,3232
CCCCGG,3.1997714539247,-0.35297439269817404,0.4731000035543089,0.32849142119103303,6,100638,101428,101424,790,-4,3233
GACCCG,2.0732488071219097,-0.0170268158560543,0.48326072551161,0.32787654255344,6,101548,101421,101425,-127,4,3234
CCGGGG,3.19758870002145,-0.346137635538311,0.47124117267498605,0.327222631175466,6,100645,101430,101426,785,-4,3235
CGCTGA,2.06091171061035,-1.17128175604484,0.47538398103795904,0.32638396221988103,6,101555,101426,101427,-129,1,3236
CGGGTC,2.06911293341116,-0.743030534910067,0.48101036204878894,0.326356097414287,6,101550,101424,101428,-126,4,3237
CGCGCG,1.9103369208801397,0.557680688710938,0.48796382550923495,0.32491838266093603,6,101654,101416,101429,-238,13,3238
TGGCGG,2.9600506134859104,-0.490850248983623,0.46584834913934403,0.324839649522049,6,101039,101436,101430,397,-6,3239
GCGGGT,2.60127007859994,-0.31791362009350105,0.46882611232321203,0.32349905603699897,6,101305,101433,101431,128,-2,3240
CGGAGA,2.22214785636943,-1.2089276237758,0.468484940076568,0.323236305334677,6,101468,101434,101432,-34,-2,3241
CTCGTC,1.99500864917809,-0.820487619205167,0.471750524988305,0.32322644193510996,6,101588,101429,101433,-159,4,3242
GTGCGC,2.4054166922289304,-0.482202634996714,0.47046071304092696,0.322660589207911,6,101381,101431,101434,50,3,3243
TCGGGA,2.7279598358380004,-0.576367786541473,0.458867640663433,0.321296104354541,6,101233,101440,101435,207,-5,3244
TCTCGC,2.52979522861708,-0.6901646872242929,0.45975260775523796,0.32010072073811696,6,101334,101439,101436,105,-3,3245
GACGAG,1.9925734147249299,-0.8265295189396,0.466595409394053,0.319665988253633,6,101591,101435,101437,-156,2,3246
TCCCGA,2.72442823096543,-0.582784715970259,0.455012112766939,0.31852729249151,6,101235,101443,101438,208,-5,3247
GACGCC,2.05958658095201,-0.774256164404846,0.469598499341705,0.31846210498395694,6,101556,101432,101439,-124,7,3248
CCTCGT,2.5574143580155,-0.665429896220912,0.456404979812115,0.31802285583450607,6,101319,101442,101440,123,-2,3249
TTAACC,2.9658181799589105,0.121480809417625,0.4420044653549571,0.317540996208203,6,101033,101451,101441,418,-10,3250
TACGTA,1.48638242133265,-0.38718902350874296,0.45975556566420706,0.317469188018639,6,101950,101438,101442,-512,4,3251
AAAACG,2.06542803210047,0.0892456707770162,0.452227876248294,0.317459482856933,6,101554,101444,101443,-110,-1,3252
CGTTTT,2.06763754300311,-1.00141503785185,0.45120718524359293,0.31684845302054804,6,101552,101447,101444,-105,-3,3253
CGTCTT,1.9452744690403798,-0.8775065121825899,0.457631253572432,0.316763157016708,6,101624,101441,101445,-183,4,3254
CCGGCT,3.11353950398778,-0.335413413811363,0.45203642381390297,0.316533638070496,6,100801,101445,101446,644,1,3255
CGGTGC,2.24591614746667,-0.747932807681396,0.46290043080555604,0.315877178940432,6,101447,101437,101447,-10,10,3256
GCGAGA,2.52479022847223,-0.689605900090374,0.45162443316238704,0.314391709719375,6,101336,101446,101448,110,2,3257
ACGGAG,2.71344940031987,-0.538038836317556,0.44574251217566496,0.31195947878349295,6,101244,101448,101449,204,1,3258
AGCCGG,3.1075874402347203,-0.34652508765165096,0.44492606614375396,0.311500095264248,6,100807,101449,101450,642,1,3259
CTAATC,2.76407763156367,0.10082596933020402,0.434219429447799,0.310424866085203,6,101219,101457,101451,238,-6,3260
ACGTGA,2.1500390947352703,-0.575309485903585,0.442422615254635,0.30804469167372195,6,101513,101450,101452,-63,2,3261
GATTAG,2.76388766620049,0.0925837869650028,0.429694481989863,0.307221327652106,6,101220,101460,101453,240,-7,3262
ACGCCA,2.5419297010798196,-0.518687982347645,0.44011166952107705,0.306490273055293,6,101327,101452,101454,125,2,3263
ACGAGG,2.54255268481208,-0.6811647548799961,0.438844554374349,0.3056509391057,6,101326,101453,101455,127,2,3264
TCACGT,2.1438667003147303,-0.583360964213595,0.43781180805809294,0.30478230558212893,6,101515,101455,101456,-60,1,3265
TCTCGA,2.47049641008789,-0.719266581880229,0.430650713099304,0.302552697024741,6,101359,101459,101457,100,-2,3266
CTCGAG,2.12743239295191,-1.26961364839708,0.438613923831641,0.301756979150669,6,101524,101454,101458,-70,4,3267
CGTCAG,1.95902726102176,-0.9901189878697321,0.434610842914889,0.29744011198682696,6,101612,101456,101459,-156,3,3268
TCGCTC,2.49587611937453,-0.435757209581674,0.425833498512684,0.29619550373810305,6,101349,101462,101460,113,-2,3269
CGATGG,2.02096143697669,-1.08994361817935,0.431297278390318,0.295769622467577,6,101575,101458,101461,-117,3,3270
TGGCGT,2.5228262663456,-0.5319829451668421,0.424715652956126,0.295684747972835,6,101337,101464,101462,127,-2,3271
TCGAGA,2.46190500337367,-0.7207326140916701,0.420497719161091,0.29534692563659604,6,101360,101469,101463,109,-6,3272
ATCGTG,1.97954404484631,-0.6910497078157329,0.42577482637118397,0.29500788579853304,6,101604,101463,101464,-141,1,3273
CTGACG,1.9540577454861499,0.310634554132065,0.42923803407236605,0.29372035603186203,6,101615,101461,101465,-154,4,3274
GAGCGA,2.49543365872451,-0.458127889687217,0.42226786341466205,0.293706652763439,6,101350,101466,101466,116,0,3275
CTCCGT,2.68401864365185,-0.5660683469784439,0.41860721443506005,0.29273238744097696,6,101262,101472,101467,210,-5,3276
CACGAT,1.97793198450981,-0.695785704743869,0.420354848675672,0.29119728158740005,6,101606,101470,101468,-136,-2,3277
CGCACA,2.17538386845947,-0.8942138025456801,0.42220884441559703,0.29085446747845395,6,101497,101467,101469,-30,2,3278
AAGACG,1.90768665246429,0.3143744458699939,0.42009695072600395,0.29040949641594105,6,101659,101471,101470,-188,-1,3279
CCATCG,2.0113355557614,0.541043754942306,0.422909061375099,0.289890471060033,6,101580,101465,101471,-115,6,3280
GGCGTC,2.00896726527432,-0.816538450253022,0.420864693911952,0.284979269384922,6,101581,101468,101472,-113,4,3281
GCGCAG,2.67669184536519,-0.6757839629578599,0.409330368475606,0.28304395867764803,6,101266,101475,101473,209,-2,3282
GACGGC,2.00520156218297,-0.82617263912495,0.41553740359659097,0.281311274377482,6,101584,101473,101474,-111,1,3283
GCCGTC,2.0036347490215,-0.8243395105547858,0.415208254635196,0.281077202327225,6,101586,101474,101475,-112,1,3284
CTGCGC,2.6715450048422302,-0.676150744139456,0.405341821869735,0.280244936437688,6,101270,101476,101476,206,0,3285
CGAACT,2.0522994273448,-0.656860623224278,0.401869261817122,0.279000556793379,6,101561,101479,101477,-82,-2,3286
TCCGGC,2.22260556873273,-1.09404423037413,0.4049325761604439,0.276097566980768,6,101467,101477,101478,10,1,3287
ACCGCG,2.02428163613726,0.6384733355069029,0.40409663065369605,0.27372225191661603,6,101573,101478,101479,-95,1,3288
GGTTAA,2.90355580434501,0.0595423568276541,0.380066012764987,0.27266483648913,6,101112,101488,101480,376,-8,3289
GCCGGA,2.2122106086296003,-1.11651027693673,0.39453761605731,0.268913730850552,6,101479,101480,101481,1,1,3290
AGTTCG,2.03938971254624,0.8618434090265591,0.386186152147804,0.268049068968863,6,101567,101483,101482,-84,-1,3291
GCGGCC,2.9158340496206097,-0.387044225216142,0.38697450936286704,0.26644331300483104,6,101100,101482,101483,382,1,3292
ACGGTG,2.67598620213242,-0.309999380413924,0.378926513619959,0.264937479279302,6,101269,101490,101484,221,-6,3293
CGTGTA,1.66750023165449,-0.752741280432888,0.385637444734707,0.26468681552448603,6,101819,101486,101485,-333,-1,3294
CCGCGC,2.71737329980926,0.859967932667814,0.386001746640243,0.264120514364522,6,101239,101484,101486,245,2,3295
ACCGCC,2.2037404013725297,-0.8312572089762859,0.385743485776318,0.262811280945215,6,101484,101485,101487,1,2,3296
CGCGGT,2.00708697640947,0.5818065357005721,0.387225893949836,0.262184505067156,6,101582,101481,101488,-101,7,3297
GGCCGC,2.9080113239394,-0.394866950897352,0.37915178368165703,0.26099477666859305,6,101107,101489,101489,382,0,3298
GGCGGT,2.19822084742175,-0.8293301892488,0.380871777873386,0.25952381156187,6,101491,101487,101490,-4,3,3299
CTTCGT,2.3984472413791003,-0.46679351813134295,0.36260623337222203,0.254262024380427,6,101387,101497,101491,110,-6,3300
AGCCGA,2.797445449144,-0.42898216778038795,0.36246898601501704,0.254254747818535,6,101204,101498,101492,294,-6,3301
TCCCGC,2.66726352880174,-0.670146342007209,0.36765048672998896,0.254136161520974,6,101272,101493,101493,221,0,3302
GCGCGG,2.70155077640984,0.844469332292322,0.37050314626475295,0.253426884864079,6,101252,101491,101494,239,3,3303
CGTATA,1.44541988855062,-0.787518860797665,0.36724528799177797,0.25327834246033804,6,101974,101494,101495,-480,1,3304
TGGACG,1.92569352170609,0.31970139668606895,0.370362716006964,0.253223086624998,6,101638,101492,101496,-146,4,3305
TCGGCT,2.79260933152547,-0.426773165063755,0.360676672561508,0.2529977973078,6,101205,101500,101497,295,-3,3306
CACCGT,2.65843206534709,-0.33199386783703005,0.36026321170995207,0.251733687812294,6,101277,101501,101498,224,-3,3307
CCGCAC,2.50020579043033,-0.581738642857724,0.36597681309542,0.251685006028879,6,101348,101495,101499,147,4,3308
GCGGGA,2.6624979506254904,-0.673588182851246,0.36164724435365997,0.249981833385533,6,101274,101499,101500,225,1,3309
ATCCCG,1.95309236526643,-0.0623700833145424,0.364665870880129,0.249508991405519,6,101617,101496,101501,-121,5,3310
TACACG,1.6443016036573503,0.15157633263177303,0.3601924866025589,0.24700631875236603,6,101842,101502,101502,-340,0,3311
AAGCCG,2.10994745084249,0.142178060387733,0.35596061152570097,0.244742313784249,6,101531,101504,101503,-27,-1,3312
CGGCTT,2.1084064065877604,-0.8646824594908941,0.35590178421198704,0.244729883922628,6,101533,101505,101504,-28,-1,3313
CGACCT,1.9471684472818402,-0.8496127452814549,0.35718036567153705,0.24434229436969102,6,101621,101503,101505,-118,2,3314
CGCATG,2.10392909569404,-0.94325412424327,0.353000401785165,0.242681140535801,6,101535,101508,101506,-27,-2,3315
CGAAGG,2.0685167920384,-1.18586129023289,0.353242179338132,0.24258154113747799,6,101551,101507,101507,-44,0,3316
AGGTCG,1.9418340611748501,0.551255356511712,0.353731489812473,0.241974222036933,6,101626,101506,101508,-120,2,3317
CATGCG,2.1011963202279498,0.5539174233984699,0.350267626319082,0.240782149696552,6,101537,101509,101509,-28,0,3318
CTAACC,2.89431112767334,0.09201849987938,0.334882504347558,0.237890159277515,6,101124,101514,101510,390,-4,3319
CGTCCA,1.9042113291808997,-0.7656093710341769,0.348195780570769,0.237869606760964,6,101661,101510,101511,-151,1,3320
CGTTGT,1.72713114402526,-0.8055829174768441,0.340207078321235,0.233952420357038,6,101771,101511,101512,-260,1,3321
GTGCGG,2.47158162315791,-0.613525691156458,0.339137656881181,0.23308777957940602,6,101358,101512,101513,154,1,3322
GGTTAG,2.88188348696036,0.08741759657398701,0.32000539178774395,0.227303179719072,6,101139,101517,101514,378,-3,3323
GGGTCG,1.92321234758239,0.47511022937999703,0.33510977622001503,0.22627374959308802,6,101644,101513,101515,-131,2,3324
CGACCC,1.9220943910516297,-0.8961315721157141,0.332106309441325,0.22417092096320201,6,101646,101515,101516,-131,1,3325
CGCTCA,2.0404822863799,-1.1466641165222902,0.32006468675636895,0.219592354870159,6,101566,101516,101517,-50,1,3326
CGTTCC,2.03713357547876,-0.674163538713353,0.319919938800894,0.219486501854242,6,101568,101518,101518,-50,0,3327
CTCGGT,2.0660992472963997,-0.9514423422300509,0.31359462492063395,0.21535685141619396,6,101553,101519,101519,-34,0,3328
TGAGCG,2.0247581089071,0.333547257511972,0.30542854550149606,0.209476367862094,6,101572,101520,101520,-52,0,3329
ACCGAG,2.05894037893353,-0.961317419722958,0.30495353961674704,0.209342285951793,6,101557,101521,101521,-36,0,3330
CGAAGC,1.82511033052294,-1.15729759026324,0.299132325192062,0.203834841318415,6,101699,101522,101522,-177,0,3331
CCTACG,1.72208059387402,0.20324159202225398,0.299038164224568,0.203087212655573,6,101775,101523,101523,-252,0,3332
CGAGAA,1.94217282853546,-1.3577999979324198,0.290584369090693,0.20108648599208198,6,101625,101524,101524,-101,0,3333
GAGCGC,2.39265198368857,-0.5911064885964089,0.289289264505468,0.198310900221474,6,101389,101525,101525,136,0,3334
ATCGAG,1.811581164633,-0.977457407010746,0.287164746526134,0.19795784086920998,6,101708,101526,101526,-182,0,3335
CTCGAT,1.81127538568656,-0.985191044179397,0.286455674272773,0.19746882625294399,6,101709,101527,101527,-182,0,3336
TCGTGA,2.15335576907272,-0.737376876302976,0.280355224855244,0.19523474682564101,6,101508,101529,101528,21,-1,3337
TTCTCG,1.9318009767958502,0.175068908179998,0.279755710314502,0.19356293565560698,6,101634,101531,101529,-103,-2,3338
CCTCGC,2.57986724603525,-0.8415806720695259,0.2802542039635,0.19321614491124,6,101310,101530,101530,220,0,3339
GCTTCG,1.8065581345325903,0.502783983788769,0.283300010342813,0.19296047126481797,6,101711,101528,101531,-183,3,3340
ACGCAC,2.0189816892176,-0.668008258123702,0.27970719782944004,0.19175918105122,6,101576,101532,101532,-44,0,3341
CCAACG,1.99481132828978,0.4465806906110711,0.279212792565589,0.19127752504500697,6,101589,101533,101533,-56,0,3342
GCGAGG,2.57823760700775,-0.842622408518423,0.277386900735921,0.19125373302806198,6,101312,101534,101534,222,0,3343
TCACGA,2.14689393387453,-0.7487404706488959,0.272432301622795,0.1896561556748,6,101514,101537,101535,23,-2,3344
ACAACG,1.6660728415633401,0.33296224693379606,0.275441357690053,0.18900176015566503,6,101820,101535,101536,-285,1,3345
AGCGTC,1.79695888345772,-0.8349469726761609,0.27254246535084503,0.185562120903691,6,101713,101536,101537,-177,1,3346
CGTTCT,1.91750367209503,-0.864313209373062,0.26545840561368,0.18359337647254395,6,101649,101538,101538,-111,0,3347
ATGACG,1.65343870137659,0.38652175406585904,0.265053547638306,0.181829840493747,6,101831,101539,101539,-292,0,3348
CGTCAT,1.65396834436679,-0.8507573590175072,0.264797948527757,0.18165827577499802,6,101829,101540,101540,-289,0,3349
CTGCGG,2.7259361445977004,-0.8192475914727171,0.262244974536474,0.18161623221632897,6,101234,101544,101541,310,-3,3350
CGAAAC,1.75107833857901,-1.22791402952994,0.26348863684072504,0.181275169901808,6,101756,101542,101542,-214,0,3351
CACTCG,1.98351976851981,0.21798575484793398,0.26310216889628196,0.18019039897873104,6,101600,101543,101543,-57,0,3352
GCGCAC,2.19997241853302,-0.684160104642388,0.26355535131075697,0.179555631627593,6,101488,101541,101544,53,3,3353
AGAACG,1.9102823709885701,0.21550322041859898,0.258693911543805,0.178847139397907,6,101655,101546,101545,-109,-1,3354
CTCGGA,2.01297588224683,-1.30326701212648,0.260471259871057,0.178565625228303,6,101579,101545,101546,-34,1,3355
TTCGTA,1.5747211574064197,-0.8640953612419309,0.25392309470957,0.17581448702743202,6,101886,101548,101547,-338,-1,3356
CTGCGT,2.3210419803035496,-0.828050104809771,0.25344246119942004,0.175397564095193,6,101419,101549,101548,130,-1,3357
CGTTCA,1.93715179543258,-0.8001791527185899,0.252349104530877,0.17461485702017598,6,101629,101550,101549,-79,-1,3358
GACGCT,1.78093289944187,-0.8502344115654521,0.256113188028085,0.174283377169651,6,101727,101547,101550,-180,3,3359
TGCGTT,1.93431173227999,-0.792221620195377,0.251755371513296,0.17421394003913,6,101631,101551,101551,-80,0,3360
TCCGAG,2.0052604560609697,-1.2991180754025,0.25127361674418397,0.17221795337966503,6,101583,101552,101552,-31,0,3361
GTTTCG,1.73674105845789,0.388609440707141,0.24909784298993803,0.17134930134948403,6,101763,101553,101553,-210,0,3362
CCGCAG,2.71121375629377,-0.839073962141937,0.246040369291531,0.17029538831099,6,101248,101556,101554,308,-2,3363
CGAGTG,1.96668286623929,-1.0845782901246999,0.24735330283367998,0.16933765404098,6,101609,101554,101555,-55,1,3364
CGTATG,1.63321593741104,-0.6971558278686271,0.246291871707015,0.168864077417139,6,101854,101555,101556,-299,1,3365
AAAGCG,1.8932884979739402,0.0535007840096782,0.24170003852917604,0.167013774008219,6,101667,101560,101557,-107,-3,3366
CCCGAA,1.95923621175733,-1.3523686132109198,0.243637676033138,0.166719301130441,6,101610,101557,101558,-53,1,3367
CAGCGC,2.54029822447022,-0.860688989788519,0.24133761707736998,0.166184940263076,6,101330,101561,101559,231,-2,3368
ACACCG,2.02789705287555,0.171060372869876,0.24231108305550303,0.16616926565653697,6,101570,101559,101560,-11,1,3369
ATCGCC,1.8320099352977601,-0.971768448038317,0.24358344091146103,0.16602126380952698,6,101693,101558,101561,-135,3,3370
GCGCTG,2.53705075109148,-0.8555977162345431,0.240336473833638,0.16550208302323702,6,101332,101562,101562,230,0,3371
TTCGGG,1.9570018624414598,-1.34865477954836,0.24011214878751602,0.164343740116012,6,101614,101563,101563,-51,0,3372
CGTTTG,1.9194450975667,-0.9450072564130229,0.23688873680001002,0.163853663287987,6,101647,101566,101564,-81,-2,3373
TCGTGC,2.13965895009186,-0.716201866036515,0.236461482001124,0.16275332765788902,6,101517,101567,101565,50,-2,3374
CGAGCA,1.95883540273746,-1.12310730985211,0.23725950919684802,0.16236241871048598,6,101613,101565,101566,-48,1,3375
GCACGA,2.14017741682415,-0.713758182477992,0.233957273475152,0.161008220752078,6,101516,101569,101567,53,-2,3376
GGAACG,1.9493691894202199,0.318428285737998,0.23409457671995104,0.160160343373007,6,101620,101568,101568,-52,0,3377
CGCCGG,2.05546410766605,-0.264222052241371,0.237791115093763,0.159158541951573,6,101560,101564,101569,4,5,3378
CGATCC,1.8232537629482999,-0.7008507168462651,0.233265681337995,0.158942958703112,6,101700,101570,101570,-130,0,3379
TGCGAT,1.78596805813405,-0.848489786464345,0.23063725243491698,0.158877511545743,6,101724,101574,101571,-150,-3,3380
CGGTGT,2.01463457077725,-0.840380640961778,0.231618854116133,0.158817358061323,6,101578,101573,101572,-5,-1,3381
GGCGAT,1.8214171848890701,-0.9850586921209741,0.231753026302696,0.157924375136301,6,101704,101572,101573,-132,1,3382
CCGGCG,2.05018705056521,-0.258482698219959,0.23251405799292102,0.15559935935338198,6,101564,101571,101574,7,3,3383
AGCGGA,1.98029255862356,-1.15235992350036,0.22662964233070299,0.155203985952613,6,101603,101577,101575,-26,-2,3384
GCAACG,1.74558401841987,0.40773320981844,0.22779739280832897,0.154824238745364,6,101760,101575,101576,-185,1,3385
CGTTGC,1.74668584744245,-0.9351338448517929,0.22728412087724,0.154505521971113,6,101759,101576,101577,-183,1,3386
CAGCGT,2.32167800509922,-0.8807055452911501,0.22132106157474,0.153158915122236,6,101418,101579,101578,161,-1,3387
CAGCGG,2.7152188710464,-0.8832563303010641,0.21877027656482503,0.15144943659349303,6,101242,101580,101579,338,-1,3388
CGTAGG,1.6440369599529499,-0.8646613814981949,0.22277954136168202,0.15093048223722902,6,101843,101578,101580,-265,2,3389
CCCGTT,1.9354699217022602,-1.0654765901964498,0.218256285024392,0.149263061276362,6,101630,101581,101581,-49,0,3390
ACGCTG,2.31475538462781,-0.880750506864112,0.215183683204071,0.148880949624457,6,101422,101582,101582,160,0,3391
CCGCTG,2.70495036959628,-0.885510007842393,0.21042418222578801,0.145627927777492,6,101251,101585,101583,334,-2,3392
GACGCA,1.7715308231750801,-0.892959832617416,0.213953687340949,0.145538699062867,6,101734,101583,101584,-151,1,3393
GAGCGG,2.5119250921461203,-0.6693213672275921,0.211074385874287,0.14523831801815698,6,101341,101584,101585,243,1,3394
CGAGCT,1.89865609964573,-1.1107453713325501,0.209837630525465,0.143335099749797,6,101663,101586,101586,-77,0,3395
TGCTCG,1.9277095455208102,0.16442186198393802,0.20953827603228503,0.143274888303316,6,101636,101587,101587,-49,0,3396
TGCGTC,1.7621301698699299,-0.8913575132457628,0.20836095139480199,0.141714157455677,6,101746,101588,101588,-158,0,3397
AGCTCG,1.8957797793501399,0.16184489618152403,0.206961310229872,0.141357613209463,6,101666,101589,101589,-77,0,3398
GGCGAA,1.91792878192909,-1.29128091602749,0.20265416922882,0.138512196894949,6,101648,101590,101590,-58,0,3399
CATACG,1.5926968313043501,0.412894309655911,0.20206534743105703,0.13834640040601998,6,101875,101591,101591,-284,0,3400
CAAACG,1.8798861019323798,0.27863847460818497,0.19669851198435,0.135854166836125,6,101675,101593,101592,-82,-1,3401
ATCGCA,1.7527427454723001,-0.8816835482994191,0.196727196862172,0.135362222168357,6,101754,101592,101593,-162,1,3402
AAACGG,2.42201490678148,-0.6416196229740501,0.192696322229862,0.135188097534664,6,101372,101597,101594,225,-3,3403
TACGTT,1.51442370719441,-0.6086268070172379,0.1921645564633,0.132814827567373,6,101923,101598,101595,-325,-3,3404
GACGTC,1.55671176181649,-0.680841398882297,0.19629410141610198,0.13258748651413302,6,101903,101594,101596,-309,2,3405
TTCGCC,1.9107196506231001,-1.3008198526938999,0.19350601394523398,0.132231601635221,6,101653,101595,101597,-58,2,3406
GCGATC,2.26258090840209,-0.132534564408132,0.190976700316241,0.13192710093593998,6,101438,101599,101598,161,-1,3407
TCCGCT,1.94556638195327,-1.17087652685299,0.19273783655357202,0.131853363868707,6,101622,101596,101599,-26,3,3408
AACGTA,1.50860157179749,-0.6278480213649069,0.189418610054313,0.130874703422124,6,101929,101601,101600,-328,-1,3409
GCGCGC,2.32388288104225,0.664289424013456,0.190323237985885,0.128574881854784,6,101417,101600,101601,183,1,3410
AGCGCA,1.9097514764906,-1.14909187473699,0.188175582949988,0.12857377050107402,6,101656,101602,101602,-54,0,3411
ACGCAG,2.25372146852406,-0.9016117639648851,0.183502567468581,0.12672055440392602,6,101441,101605,101603,164,-2,3412
TAGGCG,1.7425347944990701,-0.588036835681434,0.186359865294943,0.126667619366463,6,101761,101603,101604,-158,1,3413
TGCGCT,1.9023441649288202,-1.14475766849541,0.184172895440295,0.1258299346336,6,101662,101604,101605,-58,1,3414
GATCGC,2.25355829080245,-0.141557182007769,0.181954082716604,0.125660863593591,6,101442,101606,101606,164,0,3415
AATACG,1.50063340214832,0.247313816137654,0.17998935237087801,0.124329443506791,6,101939,101607,101607,-332,0,3416
AACGTT,1.79153328185061,-0.5943953806820451,0.17671802504476397,0.12312361597760901,6,101720,101611,101608,-109,-3,3417
CGAAGA,1.70408769722305,-1.4387569966258502,0.178109691892173,0.122367658582919,6,101788,101610,101609,-178,-1,3418
CGTATT,1.49626839749698,-1.0278538809098101,0.175470334800133,0.121211278680847,6,101942,101612,101610,-330,-2,3419
ACCGGC,1.9960045400404,-1.03652452625949,0.178331547468106,0.120681971696696,6,101587,101609,101611,22,2,3420
GTCGGC,1.76717883825218,-1.0583268772751702,0.17907626688980496,0.120261126285174,6,101741,101608,101612,-133,4,3421
TAAACG,1.4942799281761399,0.13956947096205302,0.173635878398702,0.119918332200114,6,101943,101614,101613,-329,-1,3422
CGAGTC,1.69904861198136,-0.973720839679833,0.17463219387448903,0.11851824428387402,6,101793,101613,101614,-180,1,3423
CGGTCT,1.9253877427596497,-0.97345330436087,0.17288312038387801,0.118202861610861,6,101639,101615,101615,-24,0,3424
GCCGGT,1.98936499361006,-1.04065458710942,0.17169200103777302,0.116181613291176,6,101596,101617,101616,21,-1,3425
GCCGAC,1.76228904980079,-1.0715536955560698,0.17230096819048402,0.11567298051472001,6,101745,101616,101617,-129,1,3426
GACTCG,1.6949490454784297,0.125012920016292,0.17012933406464004,0.11544733750661,6,101799,101618,101618,-181,0,3427
GCGCTC,2.2705989489695297,-0.6927928910839289,0.168797817010429,0.11526890566644699,6,101435,101619,101619,184,0,3428
CGGGTA,1.5876393743655601,-0.8862681957775909,0.166381955774291,0.112509018770892,6,101879,101620,101620,-259,0,3429
TTCGTG,1.8450429212331598,-1.2333119514098,0.16248656046646698,0.11214098066653098,6,101685,101621,101621,-64,0,3430
ACGTTT,1.9939500552087,-0.660047436295312,0.159108020660501,0.11149572344955498,6,101590,101623,101622,33,-1,3431
TGAACG,1.8421473945746898,0.36886484231205,0.161206134761674,0.11122965435693599,6,101688,101622,101623,-66,1,3432
AAACGT,1.9902353894626799,-0.67730748933576,0.15700845586815196,0.10999766208480699,6,101595,101624,101624,29,0,3433
TACCCG,1.5795960016834398,-0.237211602515185,0.15655357203398199,0.10581979013460001,6,101885,101625,101625,-260,0,3434
AGACCG,1.9083266365440101,0.102367532740681,0.15433979722723198,0.10544954808159901,6,101658,101626,101626,-32,0,3435
CGCCTA,1.7053413862841698,-0.8255041094440401,0.150324750997125,0.102035346950289,6,101787,101627,101627,-160,0,3436
CGTAAG,1.5045672780451202,-0.8323909191133921,0.14699601270935503,0.10036767729040401,6,101934,101629,101628,-305,-1,3437
AGCCGC,2.60993191622902,-0.6466926245686221,0.144758529226783,0.0998912725281065,6,101301,101631,101629,330,-2,3438
CAGTCG,1.70313144063337,0.173440143428557,0.147115892023233,0.099857282216812,6,101789,101628,101630,-161,2,3439
TACGGG,1.5692178007982,-1.17119376738465,0.146499294172672,0.0990045686989811,6,101891,101630,101631,-261,1,3440
CGACTG,1.69787902120476,-1.1482231626819601,0.142548215505629,0.0967405281504346,6,101796,101632,101632,-164,0,3441
CTTACG,1.4979369827606699,0.218631292624051,0.14006292330773298,0.0956144997091851,6,101941,101635,101633,-306,-2,3442
CACGAC,1.6979126007330803,-1.00070341281847,0.14033546489894103,0.0952237397318801,6,101795,101634,101634,-161,0,3443
CCCGTA,1.56228531642398,-1.18918212610447,0.14070397480877803,0.0950508320104609,6,101898,101633,101635,-265,2,3444
AGCGGT,1.8897218251031598,-0.944229352173915,0.136058908810304,0.09291897481281401,6,101669,101637,101636,-32,-1,3445
GTCGTG,1.69022337523038,-1.00456625367187,0.136454156755253,0.0925954844941792,6,101803,101636,101637,-167,1,3446
CCGCTC,2.43397425144697,-0.7272294987191351,0.134361209375223,0.0922191083361417,6,101367,101638,101638,271,0,3447
CGGTTT,1.84263700840395,-1.05502622444592,0.12574729475001,0.0867782546118764,6,101687,101640,101639,-47,-1,3448
CGTTTA,1.4457111833403602,-0.976921698896154,0.124913120643505,0.0861562417669104,6,101973,101642,101640,-331,-2,3449
GATACG,1.3214694743656898,0.4575515872571889,0.126435878702143,0.0858190734843746,6,102048,101639,101641,-409,2,3450
CGTAGA,1.48250215142243,-1.09569446116359,0.124930886086659,0.08524268295209199,6,101954,101641,101642,-313,1,3451
TATACG,1.20285136174098,0.184039560895966,0.123215673147881,0.0843436239728946,6,102124,101643,101643,-481,0,3452
TCACGG,2.2228810385554,-0.9004382769300109,0.120734495341678,0.0833042614523939,6,101466,101644,101644,178,0,3453
CCGAGC,2.4181138752157403,-0.7634565071819,0.11693924591997999,0.0802207540366479,6,101375,101646,101645,271,-1,3454
GCATCG,1.67299622083996,0.45133497974202497,0.11698067222982698,0.0793232320304641,6,101815,101645,101646,-170,1,3455
GATGCG,1.6719853161001998,0.394497258052212,0.116654510401069,0.0791050486468909,6,101817,101647,101647,-170,0,3456
CGTATC,1.30767770973377,-0.7927569656049742,0.115666789328488,0.0784742861291964,6,102058,101648,101648,-410,0,3457
CTCGAC,1.64041474171848,-1.1809500124453503,0.11559503030469301,0.078292808891464,6,101849,101649,101649,-200,0,3458
GCTCGG,2.4133882049676805,-0.7474916221745009,0.11409908591985699,0.0782724956585227,6,101377,101651,101650,274,-1,3459
TCGAAC,1.98697363742676,-0.562034772219421,0.11251200517502001,0.0779628167851181,6,101597,101654,101651,57,-3,3460
GCTACG,1.4731250457082299,0.19656316977389002,0.11525098625528699,0.0776272424793117,6,101959,101650,101652,-309,2,3461
GGATCG,1.70208496224586,0.443642941384303,0.113982390883487,0.0773710891357349,6,101790,101653,101653,-137,0,3462
GTCGAG,1.6384762412682599,-1.1747582066157,0.11405982316138699,0.0772595535656577,6,101852,101652,101654,-200,2,3463
CACGAA,1.79357448309838,-1.2828770271018202,0.110386893150356,0.0760426495680183,6,101717,101655,101655,-62,0,3464
ACGTAT,1.70105852154776,-0.44462907078750796,0.108839949137568,0.0756340654414038,6,101792,101657,101656,-135,-1,3465
GGACCG,1.9272570508310198,0.11484056140056402,0.109584058258735,0.0739931392775004,6,101637,101656,101657,19,1,3466
CGATGC,1.66395729217009,-0.9352547155142421,0.108626486470962,0.0736361501843993,6,101823,101659,101658,-164,-1,3467
CGACTC,1.63355899657392,-1.04097287331955,0.10873928516013699,0.0736330269728787,6,101853,101658,101659,-195,1,3468
GTTCGA,1.97924315722556,-0.565786614046376,0.106242613008083,0.0736123125101988,6,101605,101662,101660,57,-2,3469
CCGTGA,2.2082364253672,-0.9120666412184109,0.10566545993980901,0.0728746120063049,6,101482,101663,101661,181,-2,3470
CGTAGC,1.46577207140297,-1.05560203597911,0.10820080606720099,0.0728602283188304,6,101967,101660,101662,-307,2,3471
CGGTCC,1.9242227572313702,-0.7414604782054179,0.106549764659086,0.0719378532278819,6,101641,101661,101663,20,2,3472
AACGAA,1.7163770132723999,-0.9802099623298142,0.10317685742022001,0.0717199989513359,6,101780,101665,101664,-115,-1,3473
TCGTGG,2.2045639411038103,-1.02466602795165,0.10387848592434801,0.0716444669003976,6,101483,101664,101665,181,1,3474
CGCATC,1.65887680455821,-0.945670526967085,0.102861255948081,0.0697114081537501,6,101824,101666,101666,-158,0,3475
GCCCGT,2.2346963961259303,-0.814163524443364,0.10192850682528,0.0695249532010801,6,101457,101667,101667,210,0,3476
ACGGGC,2.23450129852797,-0.8085979116453041,0.100596244216984,0.0686154509980442,6,101459,101668,101668,209,0,3477
CTCGTT,1.7511184545994198,-1.1374234831435,0.0990731881180782,0.0681758407122833,6,101755,101669,101669,-86,0,3478
AAGCGA,2.2954521834730497,-0.48454878021143705,0.09667593404931199,0.0675860295605144,6,101428,101672,101670,244,-2,3479
CCACGA,2.20130324601155,-1.02125527048725,0.09727119254989698,0.0670619924810019,6,101486,101670,101671,184,1,3480
ATACGT,1.68873803715972,-0.44785740470043606,0.0965194647495284,0.0670484262776969,6,101806,101673,101672,-133,-1,3481
ACTTCG,1.6199948010421101,0.320050554906967,0.0967366768523235,0.0662932583604705,6,101864,101671,101673,-193,2,3482
AACGTC,1.5815085293185902,-0.7313744638543871,0.0954804148043138,0.0653486632540752,6,101883,101675,101674,-208,-1,3483
TCGCTT,2.29055577526431,-0.48446831396962203,0.0917260121109056,0.0641262985429331,6,101430,101676,101675,246,-1,3484
CGCACG,1.3211717330736399,-0.415113774150685,0.0959412135368307,0.06338669385696799,6,102049,101674,101676,-375,2,3485
CGGAAA,1.8062171922994301,-1.53196559580024,0.0909425795991581,0.0626761985171713,6,101712,101677,101677,-35,0,3486
GCGTTC,1.99236401540916,-0.582862679736037,0.0891665473184204,0.0610935351903982,6,101593,101679,101678,86,-1,3487
GAGTCG,1.6146506628561899,0.275405495018942,0.0902342447493201,0.061072362260836,6,101867,101678,101679,-189,1,3488
AACGAG,1.7396869971379099,-1.1547457690008,0.0880985376931491,0.060593048346234996,6,101762,101680,101680,-82,0,3489
CTTTCG,1.7335808339341,0.107802924497703,0.0815355674527485,0.0560779959890341,6,101764,101681,101681,-83,0,3490
CGTGCG,1.30131336547671,-0.227619648544858,0.0775439339741677,0.0512028733461968,6,102062,101682,101682,-380,0,3491
TTTCCG,1.78930659808977,-0.18491438219995399,0.0720929614119044,0.0496679710829684,6,101722,101683,101683,-39,0,3492
ATTTCG,1.55857675211521,0.0009436240370046529,0.0709335366472583,0.0490902209507328,6,101901,101684,101684,-217,0,3493
CTCGCA,1.7911879407775,-1.45124582269946,0.0707703411539775,0.0481718484951366,6,101721,101685,101685,-36,0,3494
AAACCG,1.7855128784273502,-0.187159749119498,0.069914342703159,0.0481503400105013,6,101725,101687,101686,-38,-1,3495
CGAAGT,1.5962557057345501,-1.16445842406205,0.0702777004036754,0.0481251098755692,6,101873,101686,101687,-187,1,3496
TACGGT,1.49034410265364,-0.761706063341535,0.0676255960281083,0.0461572924829586,6,101947,101688,101688,-259,0,3497
TCGTGT,1.7702217105501699,-1.07837153820014,0.0656279063277943,0.0451907765489741,6,101736,101690,101689,-46,-1,3498
CGGATG,1.8488998305829099,-1.1022698207800201,0.0658841139217934,0.0449358435703953,6,101683,101689,101690,6,1,3499
CCCCGA,2.56264430717545,-0.7624166284854409,0.06365776776704199,0.0438612987007976,6,101317,101691,101691,374,0,3500
GAACGT,1.77080376419512,-0.6113594926799579,0.0631872847144841,0.0435039830335467,6,101735,101692,101692,-43,0,3501
TCGGGG,2.55928119758905,-0.7548747167608051,0.0625040914524906,0.0430739658087812,6,101318,101694,101693,376,-1,3502
TCCGGA,1.88029809616155,-1.34327728832623,0.0626251035892587,0.0427525371620784,6,101674,101693,101694,19,1,3503
ACGTTC,1.7678933326133501,-0.610190786697748,0.0618384403567109,0.0425721688945678,6,101739,101696,101695,-43,-1,3504
CATCCG,1.84778233043852,0.239257670975475,0.0621963606184739,0.042412746092653004,6,101684,101695,101696,11,1,3505
TCGTTG,2.12678566053796,-0.496509772027162,0.0604335582457427,0.0420558507799118,6,101525,101698,101697,173,-1,3506
TGCGCA,1.81168823970391,-1.26873693850549,0.0607595457950421,0.041388071618879994,6,101707,101697,101698,-10,1,3507
GACGTT,1.54848338954918,-0.762115440509284,0.059278586857225,0.040534869690089,6,101910,101699,101699,-211,0,3508
ACCGCT,1.81076010746571,-1.0215620685335698,0.0579315620660204,0.0394572396723698,6,101710,101700,101700,-10,0,3509
CGCCAA,1.77265025617692,-1.26998499722311,0.0570517204527263,0.0388070377773569,6,101733,101701,101701,-32,0,3510
ACCGTC,1.6453713813584099,-0.7933366443323459,0.0569448869721061,0.0385759976711135,6,101840,101702,101702,-138,0,3511
GACGGT,1.6464984996574,-0.793099982184591,0.0568343410710224,0.0385081334843651,6,101838,101703,101703,-135,0,3512
TCTACG,1.40919377292628,0.0353797740607131,0.0513197134733439,0.0349340393869632,6,101992,101704,101704,-288,0,3513
TCCCGT,2.15083421541159,-0.987971991529001,0.0498248372081971,0.0343035295378102,6,101511,101705,101705,194,0,3514
TGCGAG,1.76898261704268,-1.46605483903874,0.0496530536370745,0.0337778797391952,6,101737,101706,101706,-31,0,3515
GCGGAT,2.23271321330803,-0.46573470667982303,0.0472604141066473,0.0326205999668202,6,101461,101708,101707,247,-1,3516
CGTAGT,1.40484821514506,-0.8769158510692309,0.0472769498092909,0.0321793980211963,6,101995,101707,101708,-288,1,3517
AGTGCG,1.7662600452547699,0.23621455068628303,0.0469304818491629,0.0319229437736732,6,101742,101709,101709,-33,0,3518
CGGCAA,1.8292340477068,-1.20073303625832,0.0439720009106761,0.0299672500160343,6,101696,101710,101710,14,0,3519
GCCGAA,1.75891754928934,-1.45276069271617,0.0433190135651422,0.0294548201488178,6,101749,101711,101711,-38,0,3520
CGCACT,1.76356636346758,-1.2298260889272299,0.043148763844048,0.0293437485492391,6,101744,101712,101712,-32,0,3521
TCATCG,1.5981598724389101,0.320139567196771,0.042144323828774,0.0288615616044415,6,101872,101713,101713,-159,0,3522
AGCGAC,1.5672812212208402,-1.07049312069361,0.0413032158899629,0.0279065448505117,6,101893,101714,101714,-179,0,3523
GCGGCT,2.5040147138144504,-0.7471262938720341,0.0403235437532317,0.0277397555314156,6,101346,101716,101715,370,-1,3524
GTCGCT,1.56358577756908,-1.0617130476576702,0.0403276533793022,0.027248142008805,6,101896,101715,101716,-181,1,3525
TGCGGA,1.82244864449574,-1.3317856646100001,0.039432927834623,0.0268720972839112,6,101701,101717,101717,16,0,3526
ACTACG,1.39666353931826,0.33798567589860107,0.0387894798653186,0.0263916827731563,6,102000,101718,101718,-282,0,3527
TTGCCG,1.82162726873457,-0.11229468118275,0.0382876290495329,0.0260910973950557,6,101702,101719,101719,17,0,3528
ATGCCG,1.8210438172975,0.129745329518185,0.0377041776124578,0.0256908924821615,6,101705,101720,101720,15,0,3529
TTCGGC,1.7544378242467702,-1.4546331350213,0.0375481105928301,0.0255313927455852,6,101750,101721,101721,-29,0,3530
TTGGCG,1.75333041454007,-0.45455605532675103,0.0364407008861267,0.0247791063421103,6,101753,101722,101722,-31,0,3531
CGGCAT,1.8215610141024097,-1.1748146234297,0.0362989673062852,0.0247336572877385,6,101703,101724,101723,21,-1,3532
CGACAC,1.59392288720903,-1.12841298881538,0.0363457513748937,0.0245772259009614,6,101874,101723,101724,-151,1,3533
TAGACG,1.3949948656698399,-0.19831734092444897,0.0359625122998164,0.0244686080852128,6,102002,101725,101725,-277,0,3534
ACGTCT,1.9045402098438102,-0.711538468687476,0.0340832665737825,0.0235613846751352,6,101660,101726,101726,66,0,3535
CGTAAA,1.35290649011886,-1.19704645727255,0.0337235283756812,0.0231907410289693,6,102027,101727,101727,-300,0,3536
ATCCGC,2.21779548545948,-0.459084996066997,0.0320187632341682,0.022087336511338,6,101473,101729,101728,256,-1,3537
GGACGG,2.36356569125198,-0.49049989022796603,0.0321726498522672,0.0220361976660428,6,101399,101728,101729,329,1,3538
TCCGCA,1.8165057487618,-1.33326050482964,0.030919778941751002,0.0210634027366841,6,101706,101730,101730,24,0,3539
AAATCG,1.51617861348378,-0.0376805062485772,0.0301504989694976,0.0208366237621326,6,101920,101731,101731,-189,0,3540
CCGTCC,2.35663484926765,-0.490537998749927,0.0260550498543477,0.017839892171665,6,101403,101732,101732,329,0,3541
CGAAAG,1.67622399273611,-1.49568483405669,0.0246355332913488,0.016910870179712,6,101812,101733,101733,-79,0,3542
ACACGA,1.73185437094051,-1.11872918793026,0.0227768034256144,0.0156607422423795,6,101765,101734,101734,-31,0,3543
CGATTT,1.5114753021101102,-1.22854122018509,0.0222704994181573,0.015390977828271002,6,101927,101735,101735,-192,0,3544
AGCGAA,1.67253168084899,-1.3430781577141202,0.020943221404222,0.0143746090578374,6,101816,101736,101736,-80,0,3545
CGATGA,1.57388340798001,-1.16318025319933,0.0185526022808862,0.0126955777252347,6,101888,101737,101737,-151,0,3546
TTTACG,1.33972756617471,-0.20577127630040304,0.0174684154436058,0.0120094809452955,6,102036,101738,101738,-298,0,3547
GTGTCG,1.5680292164090202,0.19068590614881697,0.0142599979338929,0.00963719875046703,6,101892,101739,101739,-153,0,3548
CATTCG,1.69847456674176,0.29582511048168103,0.013671875840064,0.0093922408172967,6,101794,101740,101740,-54,0,3549
AACGGA,1.72770154533135,-1.08592807383168,0.0124269326310831,0.0085439684554288,6,101769,101741,101741,-28,0,3550
ACGTTG,1.91267629892972,-0.545235068898556,0.0117082613743484,0.008096282773899491,6,101652,101742,101742,90,0,3551
AACGGC,1.72524433418275,-1.18145969959936,0.00996972148248076,0.00677149605262026,6,101772,101743,101743,-29,0,3552
TTTTCG,1.6246991151584598,-0.35019698703325397,0.00826875739894817,0.0057340944444635705,6,101861,101744,101744,-117,0,3553
TCAACG,1.4916291206994,0.225374967432554,0.00560100618512216,0.00382249975274925,6,101945,101745,101745,-200,0,3554
GGCGTA,1.42519713492496,-1.2238751805918,0.0039397163336882795,0.00264936794222549,6,101983,101746,101746,-237,0,3555
AGACGT,1.87516043168433,-0.753274607017479,0.0035451944972084704,0.0024485667930654897,6,101676,101747,101747,71,0,3556
CGCTAC,1.3605693767275,-1.1640552591256101,0.00269531727455785,0.0018082332920660899,6,102023,101748,101748,-275,0,3557
TTCGCT,1.65395470614578,-1.35490936282169,0.00190943966443058,0.0013100272545130199,6,101830,101749,101749,-81,0,3558
TACGCC,1.42346316065219,-1.2228312688578502,0.000420731002732211,0.000282876178035952,6,101986,101750,101750,-236,0,3559
GACGTA,1.19366257574096,-0.86745718494725,9.006811166756279e-05,6.08738146953104e-05,6,102128,101751,101751,-377,0,3560
TACGTC,1.19335679679451,-0.8566480480574599,-0.00011521164502958899,-7.78682971847635e-05,6,102129,101752,101752,-377,0,3561
TGCGTA,1.38650897408609,-1.09054530901901,-0.000415091617929519,-0.000282367188715448,6,102008,101753,101753,-255,0,3562
GCCGTT,1.71678234989147,-1.1842375790444901,-0.000431286786399809,-0.000292898544272629,6,101778,101754,101754,-24,0,3563
AGCGTT,1.6525931233053504,-1.0523584021882,-0.000610437093081728,-0.000418784419100695,6,101834,101755,101755,-79,0,3564
TCTCGT,1.8703282036026,-1.1510280483704098,-0.00111075339088096,-0.000767123118740353,6,101678,101756,101756,78,0,3565
CGATGT,1.55402356992479,-1.0381508198188298,-0.0013072357743339998,-0.0008940510349391519,6,101905,101757,101757,-148,0,3566
AACGCC,1.7136609577012198,-1.1955116201298301,-0.0019375780229786699,-0.00131542360080422,6,101781,101758,101758,-23,0,3567
ATCGGG,1.58568178809605,-1.3122137339128501,-0.00242078326632722,-0.0016368448023279698,6,101881,101759,101759,-122,0,3568
CGAATG,1.6761622571004298,-1.2212971296114798,-0.00477900271258669,-0.00328073817744644,6,101813,101760,101760,-53,0,3569
CGCAAG,1.71664582892752,-1.25100840526282,-0.00493006461309697,-0.00334754666157862,6,101779,101761,101761,-18,0,3570
GTAGCG,1.35203255906762,0.190819543242318,-0.0055387062681457894,-0.00371518409854242,6,102028,101763,101762,-265,-1,3571
CGAAAA,1.607809397289,-1.7214553891645,-0.0053907585631805,-0.00373533953223275,6,101870,101762,101763,-108,1,3572
GCGAGC,2.0972412338651396,-0.8865172384198491,-0.0061214853179691895,-0.0041567807573199295,6,101538,101765,101764,227,-1,3573
ACGAGA,1.8699463244814398,-1.14730722824706,-0.00607689499430109,-0.004196167305320279,6,101679,101764,101765,85,1,3574
TAACGT,1.42697964971773,-0.5859317206013829,-0.00716881098356481,-0.0049413100675333,6,101982,101766,101766,-216,0,3575
TCCGTT,1.7086574254816398,-1.0872170023757601,-0.008556211196225409,-0.0058801955172203,6,101784,101767,101767,-17,0,3576
AACTCG,1.64133863852669,-0.0542079410493326,-0.00909152700098481,-0.00623411322984279,6,101847,101768,101768,-79,0,3577
CGCAAT,1.5067772236959198,-1.10537278338764,-0.0110094019156186,-0.00751717629441315,6,101930,101769,101769,-161,0,3578
CTTGCG,1.70699809917521,0.13185518480657302,-0.0111731703133113,-0.007585505048037879,6,101786,101770,101770,-16,0,3579
ATTGCG,1.50544056661651,0.0962896992701072,-0.0139611599487015,-0.00953368551841902,6,101932,101771,101771,-161,0,3580
GGCGTT,1.70189211906476,-1.1966592658222701,-0.014997594589186002,-0.0101810469689668,6,101791,101772,101772,-19,0,3581
GCGACA,2.2513633741182404,-0.568091975407409,-0.0174003094013493,-0.0120152639902273,6,101443,101773,101773,330,0,3582
CAACGT,1.8857051480388,-0.566507327637567,-0.0175092196515756,-0.0120961765500725,6,101671,101774,101774,103,0,3583
TGTCGC,2.24464416081002,-0.557282096508601,-0.0203116053505532,-0.014024875302748,6,101449,101775,101775,326,0,3584
CAGCGA,2.2483233447545,-1.12246694563098,-0.0204403387650842,-0.0141131471437696,6,101444,101776,101776,332,0,3585
GAACCG,1.6945261843583501,-0.00084766151129223,-0.0210723513658504,-0.0142980942073388,6,101800,101777,101777,-23,0,3586
AACGCT,1.62853982900336,-1.07795731447816,-0.0218903365243168,-0.0150043321493888,6,101856,101778,101778,-78,0,3587
TACGCA,1.3681058600414,-1.10883647990429,-0.0225256238318927,-0.0153117519858917,6,102019,101779,101779,-240,0,3588
CCCGAT,1.56563764943273,-1.343233354589,-0.024350432177572004,-0.0164513460489362,6,101895,101780,101780,-115,0,3589
CGAGTT,1.62852609722272,-1.16108417560231,-0.0246774631757187,-0.0169171860994367,6,101857,101781,101781,-76,0,3590
CGGACA,1.7600206933615,-1.1771123517939601,-0.025241353434624997,-0.0171634783919812,6,101747,101782,101782,35,0,3591
GCTCGC,2.07602877009938,-0.8873630699540821,-0.0257723618597243,-0.0174886214652762,6,101545,101783,101783,238,0,3592
CGTTGA,1.4629860173907598,-1.05939261041732,-0.0262187853011913,-0.0178796402816361,6,101968,101784,101784,-184,0,3593
CGGTTC,1.6889059803632098,-0.9568900058546941,-0.0279837332907267,-0.018987263324648,6,101805,101785,101785,-20,0,3594
TGGCGA,2.23714932363698,-0.9860666278705649,-0.0293680297475998,-0.0202734717619161,6,101455,101786,101786,331,0,3595
AACGCA,1.65313713020313,-1.08668335806357,-0.0300504597448974,-0.0206116056798549,6,101832,101787,101787,-45,0,3596
GGACGC,2.10182839787204,-0.554749196519179,-0.0320766564389459,-0.0217848637803733,6,101536,101788,101788,252,0,3597
TGTCCG,1.75056934746885,0.0487270280869954,-0.0327702922161883,-0.0222799920924789,6,101758,101789,101789,31,0,3598
TCGCTG,2.2313809158796603,-1.1295090403491002,-0.0335748502809192,-0.0231735882868007,6,101462,101790,101790,328,0,3599
TCGCCA,2.23130218429884,-0.9946995638654621,-0.035899911996739996,-0.0247749280162191,6,101463,101791,101791,328,0,3600
GCGTCC,2.09463395793041,-0.554726979974515,-0.0381339313702398,-0.0258927027232308,6,101539,101792,101792,253,0,3601
GGACGT,1.8964461539949298,-0.5615277765279261,-0.0388552364476933,-0.0265412507176229,6,101664,101793,101793,129,0,3602
CTCCGG,2.6221399638714997,-1.02403867771588,-0.0393631163023773,-0.0271747439216647,6,101295,101794,101794,499,0,3603
GTTGCG,1.47569867794179,0.22386805872429602,-0.0437030486234242,-0.0294431570699656,6,101957,101795,101795,-162,0,3604
CGCAAC,1.4734454224883602,-1.21517328463954,-0.0443412031231816,-0.0298610333708787,6,101958,101796,101796,-162,0,3605
CCGGAG,2.61596660676781,-1.03047611581638,-0.0466947673231584,-0.0322298742242061,6,101298,101797,101797,499,0,3606
ACGTTA,1.3868136079923898,-0.613746797556967,-0.0473348527088984,-0.0325871812501734,6,102007,101798,101798,-209,0,3607
CGGACC,1.76870961760371,-0.9103144440383771,-0.0489633749685776,-0.0328785528790544,6,101738,101799,101799,61,0,3608
ACATCG,1.5067772236959198,0.21244010168625002,-0.0492383249142083,-0.0336195782901598,6,101931,101800,101800,-131,0,3609
GACGAC,1.30858668564231,-0.934834960837055,-0.0533925619820863,-0.0357533836994956,6,102057,101803,101801,-254,-2,3610
TGTACG,1.33570262527052,0.0625824437032687,-0.0526825284677646,-0.0357784691873094,6,102039,101801,101802,-238,1,3611
ACGGGT,1.8819810994661499,-0.840060023393182,-0.053320290976469,-0.0364053618773697,6,101672,101802,101803,130,1,3612
ACGTCC,1.88055586940126,-0.571662492669562,-0.0550694440652872,-0.0375924902756794,6,101673,101804,101804,131,0,3613
GTCGTC,1.30268906055996,-0.9289956143582522,-0.0561670126164202,-0.0376110154290035,6,102061,101805,101805,-256,0,3614
CGTACA,1.33064404480231,-1.0338579417831801,-0.0585263510367202,-0.0397338990216944,6,102041,101806,101806,-235,0,3615
GGTCCG,1.7543375703038502,0.24062238572024497,-0.0633354222684339,-0.0425153444262653,6,101751,101807,101807,56,0,3616
GGTACG,1.35779152191963,0.272798475150633,-0.0649269847058953,-0.0435595631832853,6,102026,101808,101808,-218,0,3617
CGACCA,1.5180571364343203,-1.32370036073048,-0.0719309451759873,-0.0485152528502399,6,101918,101810,101809,-108,-1,3618
TACGAA,1.24960464734457,-1.1841041799366299,-0.0710394024328682,-0.0486958630087303,6,102098,101809,101810,-289,1,3619
TTTGCG,1.61007206409441,-0.23126400261272698,-0.0724842966722843,-0.0496653156866308,6,101869,101811,101811,-58,0,3620
ATCGTC,1.28438612233294,-0.923102676345078,-0.074469950843449,-0.0504857282296204,6,102077,101812,101812,-265,0,3621
ACCGTA,1.3461393333140799,-0.916135292366089,-0.0754420083011187,-0.0512446054252377,6,102032,101813,101813,-219,0,3622
GACGAA,1.406131333311,-1.21512580981702,-0.0814583684272847,-0.0554393486089473,6,101993,101814,101814,-179,0,3623
TGGTCG,1.50508094209478,0.0702881758538343,-0.0830216292675914,-0.0559881931775718,6,101933,101815,101815,-118,0,3624
TGCCGC,2.41057090919698,-0.836696375186699,-0.083955278173514,-0.0575852137130656,6,101379,101816,101816,437,0,3625
GCGGCA,2.4121358698417996,-0.8361996792286558,-0.0843127246397728,-0.0578320513677567,6,101378,101817,101817,439,0,3626
TACGGA,1.3359247708806599,-1.2148266999613602,-0.0867937357448678,-0.0589390925595902,6,102038,101818,101818,-220,0,3627
CGTCTA,1.2642450691971299,-0.9117857744706971,-0.0921679022215525,-0.0624421425620156,6,102090,101819,101819,-271,0,3628
TCCGTA,1.32928438969798,-1.21711096878916,-0.0922969519172181,-0.0626633505191396,6,102042,101820,101820,-222,0,3629
GACGAT,1.2682431600307,-0.950280162150788,-0.0937360875936903,-0.0635118364218338,6,102089,101821,101821,-268,0,3630
TTCGTC,1.39109052498732,-1.22415939367161,-0.09655269048063,-0.0656907924947355,6,102006,101823,101822,-183,-1,3631
TGACCG,1.68551501324507,0.0112603281316126,-0.0978246264399694,-0.0663609513232234,6,101808,101824,101823,16,-1,3632
CGAAAT,1.39119049076693,-1.58980560148314,-0.0963992109713505,-0.0663690964502019,6,102005,101822,101824,-183,2,3633
GCGCTT,2.13250395816682,-0.6742786421643759,-0.0980843160838472,-0.0674959088841119,6,101521,101825,101825,304,0,3634
CGCAAA,1.58041739698485,-1.39925301386677,-0.10277019296317698,-0.0703298317709935,6,101884,101826,101826,-58,0,3635
AACGAT,1.38222517109801,-0.9116279835576702,-0.10536453064027099,-0.0725216862743631,6,102012,101827,101827,-185,0,3636
TCGCAC,1.79651560388529,-1.05585840819285,-0.108142952239703,-0.0736225390478511,6,101714,101828,101828,114,0,3637
GTGCGA,1.79633750049205,-1.06108490286033,-0.10842155482269099,-0.0738224851472547,6,101715,101829,101829,114,0,3638
CGGTCA,1.67359592100786,-1.1498666580541599,-0.111666125788261,-0.0757220551325588,6,101814,101831,101830,17,-1,3639
ACGGCC,2.22054927622177,-0.8851864227808709,-0.111167688201862,-0.0757868497720905,6,101472,101830,101831,358,1,3640
CGGACT,1.63944626115574,-1.12108000174503,-0.11305836122003,-0.0765781995781986,6,101851,101832,101832,-19,0,3641
GCCGTA,1.30693638732149,-1.3446044722442099,-0.114644954293711,-0.0767727785555701,6,102059,101834,101833,-225,-1,3642
GAGCGT,1.79156422173939,-0.993590586677229,-0.113194833575349,-0.0770604764014437,6,101719,101833,101834,114,1,3643
CGCATA,1.1683632388918,-1.19426081286949,-0.11574587816299198,-0.07815659159553599,6,102150,101836,101835,-314,-1,3644
GGCCGT,2.21531431133577,-0.8889602996326129,-0.114941565053604,-0.0783583475278225,6,101475,101835,101836,360,1,3645
AGGCGA,2.12047653096911,-1.18762262428517,-0.116688022047216,-0.0802610710312327,6,101526,101837,101837,311,0,3646
CGTACC,1.29871145567971,-0.887931744962271,-0.12286988593548599,-0.0822508375044579,6,102066,101839,101838,-227,-1,3647
TCGCCT,2.11370873970483,-1.19147757097745,-0.120735932170405,-0.0830299256368748,6,101530,101838,101839,308,1,3648
TACGGC,1.2982482353638503,-1.34557765009725,-0.12447027126167999,-0.0833273036022524,6,102068,101840,101840,-228,0,3649
TATGCG,1.1533810684765602,-0.0633476273542257,-0.128481718443224,-0.0867266544312867,6,102158,101842,101841,-316,-1,3650
ACGCTC,1.773946134343,-0.9923031298763549,-0.130712421781997,-0.0889220431394866,6,101731,101843,101842,112,-1,3651
TTTCGT,1.87175094852022,-1.07350242647958,-0.128475150764816,-0.08972900495965,6,101677,101841,101843,164,2,3652
CGCGTG,1.4487251071336398,-0.6725426182879489,-0.136802622438742,-0.0908305390531084,6,101971,101848,101844,-123,-4,3653
AGACGC,1.93736849024735,-0.88967021232282,-0.13285041080813198,-0.0908522739034217,6,101628,101844,101845,216,1,3654
CGAATA,1.1125169323747601,-1.4262534097868702,-0.134064408179183,-0.0914996681936551,6,102175,101845,101846,-330,1,3655
GCGTCT,1.9323370410528502,-0.880884213312539,-0.135262478051279,-0.0925010006848441,6,101633,101846,101847,213,1,3656
CGTAAT,1.18295020742368,-1.2115186482844,-0.136232754319495,-0.0931962098949684,6,102135,101847,101848,-288,1,3657
AGTCCG,1.6149552411474402,0.129122482516562,-0.139031598169341,-0.0940944025218075,6,101866,101850,101849,-16,-1,3658
GCCCGA,2.1623720135927202,-1.05489464697168,-0.13880261570303398,-0.0944484949485985,6,101505,101849,101850,344,1,3659
AAGTCG,1.3797273935390602,0.152306584570983,-0.14468902456781196,-0.0983951034294456,6,102014,101852,101851,-162,-1,3660
ATAACG,1.2283871378263702,0.080582922739481,-0.14380465684146398,-0.0985084721637376,6,102111,101851,101852,-260,1,3661
CACGCG,1.43909382177898,-0.20075398093159302,-0.14868023792841,-0.0986672821078791,6,101976,101855,101853,-121,-2,3662
GTACGT,1.39410120144447,-0.47759889410464,-0.145108538041066,-0.0987346911626642,6,102004,101853,101854,-151,1,3663
TCGGGC,2.15060596766234,-1.05787730724777,-0.148683151385484,-0.10114766604145098,6,101512,101856,101855,344,-1,3664
ATTACG,1.17423255643532,0.0609189133209398,-0.148026594295782,-0.101235524652419,6,102143,101854,101856,-289,2,3665
CGCGAT,1.2398571557283702,0.0755370600520831,-0.152319015769278,-0.10175776651266301,6,102102,101857,101857,-245,0,3666
ATCGTA,1.03925179271579,-0.99180360595164,-0.152759127689496,-0.104021546568689,6,102208,101858,101858,-350,0,3667
TTGACG,1.3334090462834198,0.0598701243523951,-0.15579575640853902,-0.105797348518484,6,102040,101861,101859,-179,-2,3668
TCGAGG,2.11450258966891,-1.2745989147600099,-0.154589605505661,-0.10631985809971198,6,101528,101859,101860,331,1,3669
TATTCG,1.0891363445120699,-0.163720277755051,-0.155883408817868,-0.10632904560419301,6,102187,101862,101861,-325,-1,3670
AATCGC,2.0424137374602602,-0.488194384857072,-0.15480092473947799,-0.10744025935441699,6,101565,101860,101862,295,2,3671
CGACTT,1.36614708338392,-1.26346530837623,-0.158672628029869,-0.10785841303118801,6,102020,101863,101863,-157,0,3672
CGGTAG,1.59089352627724,-0.9812413353282209,-0.162769390015615,-0.110078197346249,6,101876,101865,101864,-11,-1,3673
CCTCGA,2.10847549100586,-1.2827755032256598,-0.160940627192637,-0.11065214137195499,6,101532,101864,101865,332,1,3674
CGTTAT,1.2096960799033,-0.9708993016590419,-0.164110815718212,-0.11237043791756801,6,102120,101866,101866,-254,0,3675
TACGAT,1.0291801464873298,-1.00179485984734,-0.165853449176216,-0.11290147190580399,6,102213,101868,101867,-345,-1,3676
ACGGCA,2.1341282490397,-0.917064724196653,-0.165177769607769,-0.113653589248834,6,101520,101867,101868,347,1,3677
ACGATC,1.70775648630694,-0.49021641066917404,-0.1667051459448,-0.114545404127657,6,101785,101869,101869,84,0,3678
GCGATT,2.03256568833966,-0.50493635706261,-0.16782566203775,-0.116462985338319,6,101569,101870,101870,301,0,3679
TGATCG,1.38214453726183,0.226424183170476,-0.171624681213292,-0.11673134502772199,6,102013,101872,101871,-141,-1,3680
CGATCA,1.38577611549703,-1.18041941014474,-0.17180102033710998,-0.116847741420697,6,102009,101873,101872,-136,-1,3681
TCGTTT,1.83098601696897,-0.988395539271881,-0.16924008231606902,-0.118063071247039,6,101694,101871,101873,177,2,3682
TACGCT,1.18271132034656,-1.2609076748139498,-0.17516273910638,-0.11834481590449,6,102136,101876,101874,-260,-2,3683
TGACGT,1.7281006758135,-0.713666380942035,-0.172867361741876,-0.11887145881573699,6,101768,101874,101875,106,1,3684
ACGTCA,1.7285619472750902,-0.7194349237667841,-0.17465242041528797,-0.12008420237023198,6,101766,101875,101876,109,1,3685
CGCCGT,1.23516556192295,-0.688428947027379,-0.186415779692245,-0.12277231943296099,6,102103,101880,101877,-223,-3,3686
CGGTTG,1.6012895368988898,-1.16287759777261,-0.181726179762222,-0.12295210990810601,6,101871,101877,101878,6,1,3687
ATCGCG,1.2059875024880802,0.0513984288704634,-0.18462708178557102,-0.123195120487379,6,102122,101878,101879,-244,1,3688
ACCCGT,1.7508554987715301,-0.97623087728001,-0.18476981469501302,-0.125601973574574,6,101757,101879,101880,122,1,3689
AGCGTA,1.1709038959996,-1.2845685601236998,-0.186667369336172,-0.126066372060365,6,102146,101881,101881,-265,0,3690
TACGAG,1.1702266186286299,-1.46132799918908,-0.188805734741393,-0.12750789623234401,6,102148,101882,101882,-266,0,3691
CTCGTA,1.16652755512321,-1.4725353132494599,-0.189885416295473,-0.128221744195414,6,102151,101883,101883,-268,0,3692
CGTCAA,1.29352638184581,-1.11701224698767,-0.192501732668473,-0.130532406086761,6,102073,101885,101884,-188,-1,3693
ACGTAC,1.3472776373641397,-0.525883546219223,-0.19339319015565,-0.131367351079822,6,102030,101886,101885,-144,-1,3694
TGCCGT,2.1041386988494297,-0.9445249216658861,-0.19178382465270102,-0.131859621108211,6,101534,101884,101886,350,2,3695
ATCGTT,1.2934857688316899,-0.987048699206,-0.19415744663626502,-0.133293076795403,6,102074,101887,101887,-187,0,3696
CGGAAT,1.5137394398618502,-1.2954648990951798,-0.20153517283841896,-0.13764663446753303,6,101924,101888,101888,-36,0,3697
ATCGGC,1.3827112837692,-1.41859855551794,-0.20539128759317302,-0.137909152204214,6,102011,101891,101889,-120,-2,3698
TGTTCG,1.47895695466897,0.0519168754977013,-0.20359940609772,-0.138924758600009,6,101955,101890,101890,-65,0,3699
TCGTCT,1.8327297900455901,-0.9487329532225419,-0.203111217961284,-0.14011646359903498,6,101692,101889,101891,197,2,3700
ACGAAG,1.8328286615249398,-1.02505367746744,-0.207193315657284,-0.142910028686,6,101691,101892,101892,201,0,3701
GCCGAT,1.37708199668825,-1.43186242437074,-0.212906084922055,-0.142927305648863,6,102016,101896,101893,-120,-3,3702
CGGAAC,1.50309914278887,-1.20994293269633,-0.21217546991139397,-0.14304381840947597,6,101937,101895,101894,-42,-1,3703
CGAGCG,1.1722924392478702,-0.447448906516634,-0.219883732249787,-0.144465821066044,6,102145,101898,101895,-247,-3,3704
GTTACG,1.10767891499571,0.151685520010233,-0.214580235735401,-0.144619096756206,6,102178,101897,101896,-281,-1,3705
CGCATT,1.47273179373027,-1.3103702112363,-0.21207089717142605,-0.144655114288454,6,101960,101894,101897,-66,3,3706
AGACGA,1.82826644971646,-0.968575328980448,-0.211755527465758,-0.14603569626173799,6,101697,101893,101898,196,5,3707
CGCTAT,1.18937801170475,-1.1621303673327499,-0.22004379263859,-0.148702454696055,6,102131,101899,101899,-232,0,3708
CGCTCG,1.1632529803326699,-0.0619220773900846,-0.227361603940983,-0.14932572434197303,6,102153,101906,101900,-247,-6,3709
ATAGCG,1.1870224451016798,-0.0325092491002366,-0.22355765315875,-0.151063864303837,6,102133,101901,101901,-232,0,3710
GTTCCG,1.4930658968142398,0.108350364014154,-0.22414773986363,-0.15108909037015303,6,101944,101903,101902,-41,-1,3711
ACGAGT,1.48547245063596,-1.06243473216954,-0.22214402884467602,-0.151585770416138,6,101951,101900,101903,-51,3,3712
TTGTCG,1.329169678628,-0.0192250623975134,-0.224599539847119,-0.15251208065328603,6,102043,101905,101904,-138,-1,3713
ACCGAA,1.49118626325691,-1.33122574486307,-0.22441227246728898,-0.15313986511223598,6,101946,101904,101905,-42,1,3714
AAGCGC,2.00519108658611,-0.805006800971636,-0.223782086710885,-0.153364638136014,6,101585,101902,101906,317,4,3715
CAACCG,1.55535427711114,-0.0874780305296721,-0.230231692708909,-0.155480903243586,6,101904,101908,101907,4,-1,3716
ACTCGT,1.4777243153333899,-1.08721739897364,-0.228330576923243,-0.155770160962595,6,101956,101907,101908,-49,1,3717
AATGCG,1.4492329540913302,0.0429136507491332,-0.23170830572169301,-0.15792873010930403,6,101970,101909,101909,-61,0,3718
TTCGGT,1.4834025040995402,-1.3338927357026,-0.233487209554404,-0.159342201913399,6,101953,101910,101910,-43,0,3719
CGGACG,1.1780728021633702,-0.12121751404502999,-0.244645704462167,-0.16076439469885298,6,102138,101916,101911,-222,-5,3720
ATGCGT,1.5531023354054698,-0.9636941481020251,-0.236258812838821,-0.161579270106057,6,101906,101912,101912,6,0,3721
ACGCAT,1.5522827049371002,-0.9752444099141009,-0.23853953134145603,-0.16310971583727696,6,101907,101914,101913,7,-1,3722
CGTAAC,1.07577045206397,-1.02174957883912,-0.243412509679203,-0.163845144293934,6,102194,101915,101914,-279,-1,3723
AAACGA,1.76602608027837,-1.06992353851517,-0.23560759331126,-0.16400993287094398,6,101743,101911,101915,168,4,3724
CCGTTT,1.9923884852867402,-1.0565634921640301,-0.23740803520821502,-0.164557653201957,6,101592,101913,101916,321,3,3725
CGACAA,1.31270915892827,-1.3468256961236997,-0.244867976905871,-0.166131650123909,6,102052,101917,101917,-135,0,3726
GAACGC,1.6567405798491102,-0.924026340894336,-0.249479563499895,-0.16906596891524803,6,101826,101919,101918,93,-1,3727
ACGGCG,1.16501967991879,-0.748695582919625,-0.257698826706747,-0.16926201483290199,6,102152,101926,101919,-226,-7,3728
CTACCG,1.50065279934332,0.234377814927448,-0.252175746056377,-0.169996184186818,6,101938,101924,101920,-14,-4,3729
TCGCAG,1.98614606003765,-1.3345712371881397,-0.249456905754672,-0.170871132019645,6,101598,101918,101921,320,3,3730
GATCGT,1.62295505217326,-0.5735567567685931,-0.250045492044219,-0.171383138086337,6,101863,101920,101922,57,2,3731
CGTCCG,1.16032472055358,0.238742225332885,-0.261256621061619,-0.17156862986698598,6,102155,101933,101923,-222,-10,3732
CCGGCA,2.4441000765744,-1.00204738260871,-0.25016042801982996,-0.17175112490453,6,101364,101921,101924,557,3,3733
GAACGA,1.62497380272582,-0.9255961941443671,-0.251049416749924,-0.17205478344655897,6,101860,101922,101925,62,3,3734
CTACGT,1.6191304967532099,-0.6695000825290229,-0.251326446516821,-0.17222788243927603,6,101865,101923,101926,58,3,3735
ATGTCG,1.2989530830617702,0.0037628162731113703,-0.25481613541335196,-0.17284280605508898,6,102065,101925,101927,-140,2,3736
TGCGAC,1.29650151002891,-1.3628546588673502,-0.258829295670219,-0.173263451608007,6,102069,101929,101928,-140,-1,3737
ACGAGC,1.64691249091284,-1.1397034055380402,-0.259307652436158,-0.175667390643395,6,101837,101930,101929,93,-1,3738
GCTCGT,1.6424981352275903,-1.1222900409575,-0.260699332863144,-0.17661380706186203,6,101846,101931,101930,85,-1,3739
ATCGAA,1.22794940527397,-1.36324337583327,-0.25807870924031,-0.176786554695092,6,102112,101927,101931,-185,4,3740
ACGTAG,1.61293007187692,-0.679419525280576,-0.258685165310201,-0.177234978048635,6,101868,101928,101932,60,4,3741
CCGCAT,1.92498639175586,-0.9974952090420909,-0.260790330469446,-0.17827633858948896,6,101640,101932,101933,292,1,3742
CGACAT,1.2941264418698102,-1.32451182804021,-0.26345069396432297,-0.17864249383818698,6,102071,101936,101934,-135,-2,3743
ATGCGG,1.92290022380048,-0.989987910664109,-0.262552575400905,-0.17949535871812197,6,101645,101934,101935,289,1,3744
CTGCGA,1.9733451789958998,-1.3441536461125299,-0.262661080103342,-0.17984227779009196,6,101608,101935,101936,327,1,3745
CGATAT,0.981162193409539,-1.33803154410848,-0.265419147144406,-0.180398109828529,6,102226,101938,101937,-288,-1,3746
TGCCGG,2.42667192043089,-1.01808335104151,-0.265342254028322,-0.18210309603975602,6,101371,101937,101938,566,1,3747
TCGGGT,1.8332459685482299,-1.05417921904795,-0.267439486631238,-0.182327207418393,6,101690,101939,101939,249,0,3748
GTCGCA,1.28330290223883,-1.3753192677731,-0.272712646371305,-0.182471847107083,6,102078,101944,101940,-134,-4,3749
CGAATC,1.21618111324229,-1.30470260134947,-0.269847001271987,-0.18250451527304198,6,102117,101940,101941,-177,1,3750
ATATCG,0.974994525974669,-0.206574689611404,-0.27002522735526896,-0.183491368964744,6,102228,101941,101942,-287,1,3751
AGTACG,1.08543008196856,0.0283194611522823,-0.273602271401472,-0.18424055217308302,6,102189,101945,101943,-244,-2,3752
CGAACA,1.4120896099903602,-1.41784497335644,-0.27109797995767,-0.18452480193816898,6,101991,101942,101944,-49,2,3753
TCCGAA,1.44165657389148,-1.66487616703547,-0.273941961832712,-0.186655289325651,6,101975,101946,101945,-29,-1,3754
CCGCTT,2.15713636787346,-0.8474581425703921,-0.271263816489864,-0.18679463141370103,6,101507,101943,101946,436,3,3755
TTCGAT,1.21500582689153,-1.3812142532501102,-0.274198975800429,-0.18778244809971303,6,102118,101947,101947,-171,0,3756
GCGCAT,1.71124742721155,-1.01342226347376,-0.276717384901112,-0.187875488939091,6,101782,101949,101948,167,-1,3757
ACCCGA,1.8278366717442098,-1.0676564443024399,-0.27619538171744107,-0.188206709939822,6,101698,101948,101949,250,1,3758
ATTCCG,1.43654950293614,-0.105486277992858,-0.280664133741729,-0.191219241803548,6,101979,101951,101950,-28,-1,3759
TTCGAA,1.33599082804263,-1.66296307304553,-0.27882442876321395,-0.19165424948854504,6,102037,101950,101951,-87,1,3760
CGTACT,1.07026518861836,-1.06842116211477,-0.28614778280031705,-0.192590694047562,6,102199,101953,101952,-246,-1,3761
TGCGCG,1.293660266899,-0.30692769115629104,-0.291867462673387,-0.192672138721871,6,102072,101963,101953,-109,-10,3762
GTCGTT,1.20178055993141,-1.1029497843464902,-0.28586265553654605,-0.193293229779034,6,102125,101952,101954,-173,2,3763
TCCGAC,1.29958519972831,-1.42911204454999,-0.290402881881995,-0.194406997791822,6,102064,101956,101955,-108,-1,3764
CGTTAC,1.03134383185109,-1.0458053098176099,-0.290915318880018,-0.19553552023828,6,102212,101958,101956,-254,-2,3765
GTAACG,1.02775097038188,0.132039066611254,-0.291431991361302,-0.195858983091947,6,102214,101961,101957,-253,-4,3766
GTCGGA,1.2942915643781001,-1.43813973653016,-0.293811006984269,-0.196678198627094,6,102070,101965,101958,-105,-7,3767
CGCGCA,1.2893826608970902,-0.310463432273885,-0.29839139881030396,-0.196904848972249,6,102075,101966,101959,-109,-7,3768
TTCGGA,1.4275704608838702,-1.6884260837651202,-0.28931925277007203,-0.19707394426476602,6,101981,101955,101960,-26,5,3769
GATTCG,1.1970855027112899,0.16259190689639003,-0.292119299980664,-0.197474646701355,6,102127,101964,101961,-163,-3,3770
ATCGAT,1.06989558232029,-1.11856337784043,-0.29052207808010305,-0.19802964319580202,6,102200,101957,101962,-243,5,3771
AGCCGT,1.9773354303555,-1.08068544657378,-0.28923429277837603,-0.198062732901292,6,101607,101954,101963,347,9,3772
ACGCCG,1.1209181387645601,-0.51883260412435,-0.302124290884896,-0.19808012569852,6,102169,101970,101964,-199,-6,3773
AACGGT,1.4243224807643702,-1.0906058335518198,-0.290952131935903,-0.198149260151994,6,101984,101960,101965,-24,5,3774
ACGGAA,1.9374536126038102,-0.9993531648316759,-0.29186497194780797,-0.201944360887564,6,101627,101962,101966,335,4,3775
ACGAAA,1.7107051547180603,-1.24468674979928,-0.290928518871574,-0.202196780919877,6,101783,101959,101967,176,8,3776
AACGAC,1.1870736494090302,-1.13167782954453,-0.30051605232925604,-0.20303149862177697,6,102132,101967,101968,-165,1,3777
ACCGGA,1.51514321328172,-1.42431143839908,-0.30252977929057,-0.204042811490025,6,101922,101972,101969,50,-3,3778
ATGCGC,1.68551501324507,-1.0298851341307902,-0.302449798867588,-0.205172218880268,6,101809,101971,101970,162,-1,3779
TCGTTC,1.57060931334464,-0.9728588707032929,-0.30082964364883397,-0.20585471627135002,6,101890,101969,101971,79,2,3780
CATCGT,1.7678933326133501,-0.80758144726604,-0.300705099813877,-0.20701749729993998,6,101740,101968,101972,228,4,3781
TCCGGT,1.50940729065196,-1.4154667889889698,-0.30826570192032693,-0.20790545280607298,6,101928,101975,101973,47,-2,3782
CGGCGT,1.10233543385508,-0.8220986821142999,-0.318921984736187,-0.20898204163656,6,102182,101982,101974,-200,-8,3783
TCGTAT,1.45304233853503,-0.858029318537083,-0.304560298612007,-0.210109600655091,6,101969,101973,101975,4,2,3784
ACGTAA,1.52824856918129,-0.673329208342599,-0.304978364413239,-0.21084124611743202,6,101916,101974,101976,58,2,3785
ACCGTT,1.40598864197734,-1.10576505307309,-0.311224994700531,-0.211831661041398,6,101994,101977,101977,-17,0,3786
CGCGCT,1.2324407645967699,-0.33408198378903003,-0.322575870690278,-0.212422125158627,6,102104,101985,101978,-119,-7,3787
CCGCGG,2.2126177927530803,0.16918500947381798,-0.316241747504662,-0.21283600029525698,6,101478,101980,101979,502,-1,3788
ACGATG,1.7592170152439601,-0.8241369165572902,-0.3101577623065169,-0.213465980218435,6,101748,101976,101980,228,4,3789
CCGGAC,2.01556969553524,-0.8388198089686351,-0.3161472688884,-0.21408422573790498,6,101577,101979,101981,402,2,3790
ACGGCT,1.9536047443459,-1.10039368750648,-0.312943849881218,-0.214138837849818,6,101616,101978,101982,362,4,3791
AGCGCG,1.23001430140634,-0.348991829667138,-0.32616062779779403,-0.214769251080767,6,102108,101987,101983,-121,-4,3792
GTACCG,1.0936917763180098,-0.0415446871118181,-0.327889565297189,-0.217894196791944,6,102186,101988,101984,-198,-4,3793
CCGTTC,1.78062712049543,-0.9924114847624209,-0.32038225770796197,-0.218017302509939,6,101729,101983,101985,254,2,3794
GAACGG,1.78231510475706,-0.9959398030751141,-0.321393025680672,-0.218712773137559,6,101726,101984,101986,258,2,3795
TTACGT,1.51834143992331,-0.6743757625925079,-0.316500594624889,-0.218774850639388,6,101917,101981,101987,64,6,3796
ACCGAC,1.26109696274084,-1.18347954873049,-0.328891118869466,-0.219851770337547,6,102094,101989,101988,-105,-1,3797
GTCGGT,1.2579948499234,-1.17573514613802,-0.330107721438976,-0.220717022059107,6,102095,101990,101989,-105,-1,3798
TTCGCA,1.35888245238491,-1.68330496136773,-0.325920238516785,-0.221495107749727,6,102024,101986,101990,-38,4,3799
CGGTAC,1.08508957273535,-1.10479724967148,-0.337628933890187,-0.22429372127175198,6,102190,101994,101991,-196,-3,3800
CGTTAG,1.31720498802869,-0.876009854492983,-0.33599857236974107,-0.228049125483934,6,102051,101992,101992,-59,0,3801
ACTCGC,1.5669754422743898,-1.19656993590101,-0.337683113850606,-0.228155816899052,6,101894,101995,101993,101,-2,3802
GTCCGG,1.99127886979234,-0.8555700552013069,-0.33897700659703195,-0.22939624818207802,6,101594,101996,101994,402,-2,3803
GCGTTT,1.6973367018173102,-1.1538033655208,-0.334647908564991,-0.22992032068648896,6,101797,101991,101995,194,4,3804
CTAACG,1.31078357893357,0.16741426293830303,-0.339646586594109,-0.230437716160021,6,102054,101997,101996,-57,-1,3805
AAACGC,1.6954867267696399,-1.17065981589717,-0.336343870693257,-0.231002358443433,6,101798,101993,101997,195,4,3806
GTCCGT,1.58928735703051,-0.8614699170060479,-0.34487686840177295,-0.233226781991322,6,101877,101998,101998,121,0,3807
GGTCGG,2.15165158647131,-0.690904781914016,-0.34512551966524696,-0.23480950002094297,6,101510,101999,101999,489,0,3808
CCGACC,2.15209197879363,-0.695513982863666,-0.346894560614775,-0.235948292294828,6,101509,102000,102000,491,0,3809
CGGATT,1.3683815894935398,-1.42542439903523,-0.34850812416040006,-0.236936041554917,6,102018,102001,102001,-17,0,3810
GCGAGT,1.5518027591965202,-1.19324699944309,-0.352956296118219,-0.238386448870611,6,101908,102002,102002,94,0,3811
CGCGTC,1.01880169759412,-0.15410690048314302,-0.37181288667952594,-0.24281646058528897,6,102215,102009,102003,-206,-6,3812
ACGGAC,1.5739434710462499,-0.885491547510862,-0.362819007430629,-0.24519119920191898,6,101887,102003,102004,116,1,3813
GACGCG,1.01402702530815,-0.170626410330243,-0.378149146189505,-0.246895985530475,6,102216,102015,102005,-201,-10,3814
GGTTCG,1.34869141139421,0.191035804428427,-0.368198302259731,-0.246969741061804,6,102029,102007,102006,-22,-1,3815
TAAGCG,1.1503833400997,-0.18280631193929697,-0.367403285511843,-0.24795222808804798,6,102160,102006,102007,-154,1,3816
CGAACC,1.34484247270283,-1.32117766672954,-0.370756063021366,-0.248573104347119,6,102033,102008,102008,-25,0,3817
CCGAAG,2.0707267376892,-1.18211008724993,-0.36424972543977496,-0.2501382356242,6,101549,102005,102009,456,4,3818
TTCCGT,1.86663134172127,-1.05694916667495,-0.3631651787736861,-0.250785309771113,6,101682,102004,102010,322,6,3819
CGCTTA,1.14730939329564,-1.15564052002846,-0.37209233326957203,-0.25109257593621803,6,102161,102010,102011,-151,1,3820
GCGCGA,1.72817455763124,0.0987780244757044,-0.37518816155186696,-0.251601244665602,6,101767,102013,102012,246,-1,3821
AATCCG,1.3432878914048703,-0.19591632551991395,-0.372310644319324,-0.252872359328784,6,102034,102011,102013,-23,2,3822
CTAGCG,1.31039062218958,-0.182069597420226,-0.378427846930691,-0.25344923323817803,6,102055,102016,102014,-39,-2,3823
TCGCGC,1.71868291033541,0.0908479644038795,-0.38311822162368997,-0.256836384358597,6,101776,102021,102015,245,-6,3824
AAGCGT,1.6559428763079098,-0.9556513473814731,-0.37442663312072394,-0.256878078758429,6,101828,102012,102016,184,4,3825
AAGCGG,2.05099036012167,-0.9566955145248051,-0.37547080026405605,-0.25770585857845196,6,101563,102014,102017,451,3,3826
TGCGAA,1.3008744540011101,-1.7363172115438101,-0.380066805811909,-0.257794759789657,6,102063,102018,102018,-45,0,3827
GTTCGT,1.32398085176555,-1.0526421795112901,-0.38061295245682897,-0.258404894251309,6,102045,102019,102019,-26,0,3828
GCGATG,1.8858589521201297,-0.8946375555152242,-0.38065840126445005,-0.259933353081102,6,101670,102020,102020,350,0,3829
CTTCGG,2.05227226816257,-1.2090601423049598,-0.37966039080139397,-0.260615252865296,6,101562,102017,102021,455,4,3830
CGATAG,1.13716575636774,-1.12800082461718,-0.388812248963127,-0.26228534673535,6,102164,102025,102022,-139,-3,3831
AATTCG,1.23067386734028,-0.0284567670058742,-0.38414138946556703,-0.263185106845635,6,102107,102022,102023,-85,1,3832
CGAATT,1.22980240759014,-1.43818751758023,-0.385012849215709,-0.26377315813967,6,102110,102023,102024,-87,1,3833
ACGCTT,1.6451614096913898,-0.964478614805705,-0.38828428872517795,-0.266301092547035,6,101841,102024,102025,183,1,3834
CGGTAT,1.07773874507872,-1.22543082069751,-0.39652750643720597,-0.266968160190609,6,102192,102026,102026,-166,0,3835
ATACCG,1.07726187665065,-0.27515473113385996,-0.39732829788921,-0.267462219350544,6,102193,102027,102027,-166,0,3836
CACCGG,2.29509358028555,-1.09142400385566,-0.399166924308673,-0.27277371420722,6,101429,102028,102028,599,0,3837
CTATCG,1.11777138085878,0.203735564136855,-0.40548674333100393,-0.273357859441956,6,102173,102030,102029,-143,-1,3838
CCGTCA,1.89606757159798,-0.94688378539065,-0.4021012820391551,-0.27462593585241796,6,101665,102029,102030,364,1,3839
GCGGAC,1.72400962033196,-0.9325679740592641,-0.409895433979031,-0.274838228511936,6,101773,102034,102031,261,-3,3840
CAATCG,1.1463540974000102,0.0574962583281025,-0.40966145121012004,-0.27641471092097303,6,102162,102033,102032,-129,-1,3841
TGACGG,1.8902036367241397,-0.94765507098848,-0.40685605178832107,-0.277859689482008,6,101668,102031,102033,363,2,3842
CCGGTG,2.28372966849621,-1.09721039999689,-0.408284505963009,-0.278945385947448,6,101431,102032,102034,601,2,3843
TAGCGT,1.2101575842786398,-1.06390334145186,-0.42113345225675397,-0.28481601708620197,6,102119,102035,102035,-84,0,3844
CTCGCG,1.11993029834537,-0.642666244977487,-0.435086336941676,-0.285272092924408,6,102171,102043,102036,-128,-7,3845
GTCGTA,0.7632615300430571,-1.29198974486458,-0.4287493903622279,-0.285477951130698,6,102250,102040,102037,-210,-3,3846
CGATTG,1.1297360169680701,-1.26848298026325,-0.425594788731059,-0.287049472739617,6,102166,102037,102038,-129,1,3847
ACGCTA,1.2070605288454799,-1.07241071431161,-0.425691595724173,-0.287821857119805,6,102121,102038,102039,-83,1,3848
TTAACG,1.19295029075827,0.0494332799170039,-0.42186496604757895,-0.288685395787943,6,102130,102036,102040,-94,4,3849
ACGGTA,1.40254207130523,-0.7796905383057041,-0.42769804035315506,-0.291074750472139,6,101997,102039,102041,42,2,3850
GTATCG,0.749975693331407,-0.0898460252505942,-0.442035227073877,-0.294182047032464,6,102255,102046,102042,-209,-4,3851
GCGTTG,1.66406254919171,-0.990991394470678,-0.43404806419777103,-0.294285444572989,6,101822,102041,102043,219,2,3852
CGATAC,0.7505776463955949,-1.33240764350765,-0.44445594926795096,-0.29575089304716495,6,102254,102047,102044,-207,-3,3853
CGCGAG,1.1032995677609099,-0.6511588032820871,-0.45287536144321894,-0.29674225541323307,6,102181,102052,102045,-129,-7,3854
CATCGC,1.83098376794245,-0.9430946758052979,-0.436218328353137,-0.29730430137584,6,101695,102045,102046,350,1,3855
ACGAAT,1.32588311085068,-1.1515608438242702,-0.434742201554617,-0.298710773554047,6,102044,102042,102047,-2,5,3856
ATTCGT,1.32204190182844,-1.16118001888967,-0.435560735318592,-0.29928528159507395,6,102047,102044,102048,-3,4,3857
TACGAC,0.744360009784725,-1.31151332084782,-0.450673585878821,-0.299818039872894,6,102258,102049,102049,-209,0,3858
GTCCGC,1.68194234055887,-0.967418597346056,-0.45082554874178105,-0.301838298216378,6,101810,102050,102050,240,0,3859
CGCTAG,1.2324290807198601,-1.23053035049658,-0.45638938840040294,-0.30481918672218294,6,102105,102056,102051,-49,-5,3860
CTCCGA,1.98572095805045,-1.43277277257495,-0.4480972111614411,-0.30690762789545,6,101599,102048,102052,449,4,3861
TGACGC,1.6462469056037599,-0.9941238150201399,-0.45332479581997903,-0.307124030446104,6,101839,102054,102053,215,-1,3862
TCGATC,1.58839936904198,-0.7749575926709741,-0.45144632794659995,-0.309070675656048,6,101878,102051,102054,173,3,3863
GGACGA,1.64716863775723,-0.9792120327607259,-0.456539492680493,-0.30930639755868,6,101836,102058,102055,222,-3,3864
CGTTAA,1.1617121053744,-1.07203642618673,-0.453103151431447,-0.30975703343821503,6,102154,102053,102056,-101,3,3865
GCGAAG,1.78070003038176,-1.27432488444473,-0.45646452263457105,-0.310618996845871,6,101728,102057,102057,329,0,3866
GATCGA,1.5860265749583402,-0.7788919739786129,-0.45538070925423896,-0.311735768938824,6,101880,102055,102058,175,3,3867
ACGAAC,1.24620097002765,-1.13742337488169,-0.4628765974872489,-0.313344532899493,6,102099,102061,102059,-38,-2,3868
CTTCGC,1.77305951681255,-1.29078490656626,-0.46138515506269,-0.31389458298557005,6,101732,102059,102060,327,1,3869
ACTCGA,1.41224268868519,-1.32110576561695,-0.462218943566549,-0.314642098650028,6,101990,102060,102061,70,1,3870
CGGTAA,1.24399578000493,-1.1212105011271498,-0.471278832695337,-0.319063975797851,6,102100,102062,102062,-38,0,3871
TTACCG,1.24369000105849,-0.11521802001199401,-0.473523635619376,-0.320579032553485,6,102101,102063,102063,-38,0,3872
TCGTCC,1.6266559255470499,-0.9909465012606139,-0.47435345265634,-0.321164412061791,6,101858,102065,102064,207,-1,3873
GCGTCA,1.62381605861558,-1.0213233882604,-0.476540884908909,-0.322608844375664,6,101862,102067,102065,205,-2,3874
CGGATA,0.9935799858607041,-1.4246536911386103,-0.48068626565522604,-0.322658870659308,6,102220,102068,102066,-152,-2,3875
TCGAGT,1.39841387659241,-1.31487737094993,-0.474586667625067,-0.322963908158908,6,101998,102066,102067,68,1,3876
TATCCG,0.99246547253941,-0.357148136873969,-0.48212470200044805,-0.323618938187817,6,102223,102069,102068,-154,-1,3877
TCGGAG,1.95906804780883,-1.45780425356543,-0.474022905072214,-0.32443974602554804,6,101611,102064,102069,453,5,3878
TTAGCG,1.17041725562913,-0.28642805525884196,-0.482786304769306,-0.32607131706797,6,102147,102070,102070,-77,0,3879
ATCGGA,1.09861708625051,-1.60961833841755,-0.48948548511186396,-0.329761964414917,6,102183,102073,102071,-110,-2,3880
ATCGGT,1.0953732946389398,-1.31416082518227,-0.492729276723434,-0.331942313281046,6,102185,102076,102072,-109,-4,3881
TCCGAT,1.0968546428075998,-1.6069442771728302,-0.493133438802701,-0.3322038161715589,6,102184,102077,102073,-107,-4,3882
TTGCGT,1.54596766495193,-1.08929377100616,-0.486016945430372,-0.33233931007043394,6,101912,102071,102074,159,3,3883
CAACGA,1.5831237585825901,-1.03749545708888,-0.48849734910289505,-0.334325275926482,6,101882,102072,102075,190,3,3884
ACCGGT,1.3172635014773402,-1.3234898453566202,-0.5004094910949509,-0.335226737005331,6,102050,102080,102076,30,-4,3885
GTCGAA,0.9862777221753021,-1.62911093517214,-0.499750392338978,-0.33537009616753005,6,102225,102079,102077,-146,-2,3886
TAACGA,1.1110416431964398,-1.07027646711778,-0.49151355749995895,-0.335448464416159,6,102176,102074,102078,-102,4,3887
TCGTTA,1.10699396191208,-1.05895050837412,-0.492538563526056,-0.336158590726124,6,102179,102075,102079,-104,4,3888
TCGAGC,1.57341779685702,-1.37858216433071,-0.49818641122882895,-0.33669661151016994,6,101889,102078,102080,189,2,3889
GCGGTC,1.79625750790595,-0.8488108733906421,-0.503031611141873,-0.338165319403347,6,101716,102082,102081,366,-1,3890
ACCGAT,1.0876400276193599,-1.3320381595541,-0.502348053990945,-0.33827784008032397,6,102188,102081,102082,-107,1,3891
GACCGC,1.79164458888621,-0.8581494626584419,-0.5095300404095511,-0.34242129988252,6,101718,102087,102083,369,-4,3892
TACCGT,1.32349063073331,-0.8579786934805949,-0.505612315914739,-0.34320959685798397,6,102046,102083,102084,37,1,3893
TCGGTG,1.95294871570829,-1.1984209315749,-0.509495037541015,-0.348675171341424,6,101618,102086,102085,468,-1,3894
TTTCGC,1.6911549898318703,-1.45270204903631,-0.507674773321538,-0.34870607813444704,6,101801,102084,102086,283,2,3895
GCGAAA,1.6904547675548203,-1.46207971279662,-0.508321481868915,-0.34908811244894705,6,101802,102085,102087,283,2,3896
TGACGA,1.5583792214440502,-1.0517945753065898,-0.510995556106428,-0.349500873192311,6,101902,102088,102088,186,0,3897
CACCGA,1.9510543479326798,-1.20777832524654,-0.5155212456995599,-0.352676941598818,6,101619,102089,102089,470,0,3898
GTCGAT,0.830967617972275,-1.3816872184286397,-0.529450042428115,-0.353386037786101,6,102242,102094,102090,-148,-4,3899
GCTCGA,1.5479130586906,-1.3852818574896002,-0.523691149395241,-0.353625281095391,6,101911,102092,102091,181,-1,3900
TCGTCA,1.55115619102866,-1.06222474475006,-0.517442241398564,-0.35383680487558095,6,101909,102090,102092,181,2,3901
ATCGAC,0.8299844240000049,-1.38337286045858,-0.530433236400384,-0.353973351134096,6,102243,102095,102093,-148,-2,3902
ACGCAA,1.5117148433980399,-1.13200183895666,-0.5201157540648571,-0.35516044154665,6,101926,102091,102094,165,3,3903
CGCGGA,1.07495121275666,-0.598704011310655,-0.544909869702979,-0.356635249182642,6,102195,102099,102095,-96,-4,3904
CGCTAA,1.1188585337845,-1.3910902327336498,-0.531571631743178,-0.358337582235064,6,102172,102096,102096,-76,0,3905
TATCGT,1.0719728742179901,-1.0171503511497,-0.52755965122015,-0.35965267486298097,6,102197,102093,102097,-104,4,3906
TCCGCG,1.06662614464359,-0.603302888793733,-0.5535588608399671,-0.36219023283311,6,102201,102107,102098,-94,-9,3907
TTCGAC,0.9477930324878159,-1.67332537195169,-0.541411770204141,-0.362842156624628,6,102230,102098,102099,-132,1,3908
CAACGC,1.5634569547973702,-1.08735918474736,-0.538361076761372,-0.3636658468600129,6,101897,102097,102100,200,3,3909
TAGCGC,1.28152985212894,-1.19113473746993,-0.54836484827482,-0.366887486452552,6,102080,102102,102101,22,-1,3910
CAACGG,1.7533835008546999,-1.09492062577876,-0.5459225177927729,-0.371134337169126,6,101752,102100,102102,348,2,3911
TTATCG,0.939313955111073,-0.201908937782049,-0.548329260356878,-0.37220514282921396,6,102231,102101,102103,-130,2,3912
ACGATA,1.05382533050577,-1.0407736209851401,-0.54872987019063,-0.373809231101644,6,102203,102104,102104,-99,0,3913
GCGCAA,1.67730996809721,-1.16354929009159,-0.551663205199782,-0.37409866391484,6,101811,102105,102105,294,0,3914
TGTCGT,1.5177967879852399,-1.08552580546503,-0.548555314306981,-0.374770043989591,6,101919,102103,102106,184,3,3915
TCGCCG,1.0137212463617,-0.7914135612640529,-0.574705248024598,-0.375236352417679,6,102217,102118,102107,-99,-11,3916
CGATAA,0.93323742689393,-1.4158870776674097,-0.554352274844353,-0.37615003172504796,6,102232,102108,102108,-124,0,3917
ATACGG,1.4352972446938703,-1.09738984812338,-0.5530129786734119,-0.37675676413222,6,101980,102106,102109,126,3,3918
ACGGTC,1.54314303261042,-0.9047827728520691,-0.559003510603301,-0.377407455049418,6,101913,102111,102110,198,-1,3919
ACGACA,1.51557771638107,-1.10673505731048,-0.556043391304421,-0.37974212724638795,6,101921,102109,102111,188,2,3920
GACCGT,1.5397218866119502,-0.911468501064332,-0.562849078815443,-0.37996766262889703,6,101914,102113,102112,199,-1,3921
CCGCAA,1.8688032092507698,-1.16986795905068,-0.557981874158877,-0.380724504086519,6,101680,102110,102113,430,3,3922
TTGCGG,1.8687230840679199,-1.16263000284726,-0.559353177271472,-0.38177650122379797,6,101681,102112,102114,431,2,3923
ATCCGT,1.4234910776271101,-1.054785740031,-0.563681980729839,-0.38388128230399293,6,101985,102114,102115,129,1,3924
CCGGTC,1.9235394637302399,-0.91934082767901,-0.573561565430239,-0.38722726562868104,6,101643,102117,102116,474,-1,3925
TTGCGC,1.65780299472893,-1.17606210509753,-0.572785279521733,-0.388235857347288,6,101825,102116,102117,291,1,3926
ACGGAT,1.4169384809697199,-1.08436686318402,-0.571371742397554,-0.389029115055824,6,101988,102115,102118,127,3,3927
CGGCGA,0.991708502352452,-0.8080992315021229,-0.597955656233927,-0.39007108476339797,6,102224,102122,102119,-102,-3,3928
GACCGG,1.91698650522684,-0.9302955334065309,-0.581676111157641,-0.3926225838555471,6,101650,102119,102120,469,1,3929
GTCGAC,0.761493050474178,-1.47606011022461,-0.598924609926213,-0.393040825197699,6,102251,102123,102121,-128,-2,3930
ATACGA,1.17536483603443,-1.12963734582083,-0.585260476370868,-0.4002461584807371,6,102140,102120,102122,-20,2,3931
CCGTAT,1.3973910608071298,-1.14325101747489,-0.5897819975498161,-0.401314019665775,6,101999,102121,102123,122,2,3932
TAATCG,0.8862432171198571,-0.135827140311955,-0.599784897394422,-0.4063787161739871,6,102235,102124,102124,-111,0,3933
CTACGG,1.66577162590033,-1.01895060433899,-0.600776968326791,-0.40728808240704206,6,101821,102125,102125,304,0,3934
GCGACG,0.753698039697909,-0.41824011007394,-0.638478131799744,-0.412457911862447,6,102252,102139,102126,-113,-13,3935
GCGTAT,1.17782220363571,-1.16500796453366,-0.611538944608588,-0.41313349037914204,6,102139,102126,102127,-13,1,3936
CGTCGC,0.748977242542347,-0.41349475888439396,-0.6416373417313,-0.414410361485736,6,102256,102141,102128,-115,-13,3937
ATACGC,1.1724365642794399,-1.16276254144908,-0.618385671999118,-0.417614287120274,6,102144,102127,102129,-17,2,3938
TAGCGG,1.4042742484708997,-1.2658783282166899,-0.6231084390215861,-0.41872366629272,6,101996,102131,102130,135,-1,3939
CGATTA,0.8663791251197641,-1.4831177434943998,-0.6228256775721911,-0.42171155437994,6,102237,102130,102131,-107,1,3940
GCGTTA,1.00311744053101,-1.19458554085245,-0.628173596004386,-0.42184337503700803,6,102218,102133,102132,-85,-1,3941
TCGGCA,1.84456228369173,-1.37201475428146,-0.620127799692579,-0.42286460929376296,6,101686,102128,102133,442,5,3942
CCGTTG,1.67167953715375,-1.18118631662128,-0.624242986348374,-0.423309544695569,6,101818,102132,102134,314,2,3943
GCGTAG,1.4389064128499902,-1.0505857601416,-0.6298514001712281,-0.423760964117824,6,101977,102134,102135,157,1,3944
CTACGC,1.43801722835183,-1.04921701479876,-0.63104337878656,-0.424488519412404,6,101978,102136,102136,158,0,3945
CCGCTA,1.39529228368549,-1.27913344541836,-0.632414326830922,-0.424782919171933,6,102001,102137,102137,136,0,3946
TCGAAT,1.3045329284784,-1.33829509093339,-0.621476448663735,-0.42676594422790504,6,102060,102129,102138,69,9,3947
TAACGC,0.9933617635843509,-1.2181532706031202,-0.639390360985304,-0.429150829859284,6,102221,102140,102139,-81,-1,3948
TGCCGA,1.83338330548524,-1.38368705502518,-0.630945958011992,-0.43008324393912895,6,101689,102135,102140,446,5,3949
TCGGCG,0.924654256617632,-1.1544450709576202,-0.663448314744741,-0.43165277212751,6,102233,102147,102141,-86,-6,3950
GGTCGC,1.65148691612851,-0.9935814651680841,-0.6478022029193161,-0.43327420382843396,6,101835,102142,102142,307,0,3951
GCGACC,1.65262513858291,-0.99716891296174,-0.648549490712849,-0.433725640890296,6,101833,102143,102143,310,0,3952
GCGGAA,1.7887494433097,-1.34519990995989,-0.6377117170760229,-0.434069118952915,6,101723,102138,102144,415,6,3953
GCGCTA,1.17488684233785,-1.3017269766533501,-0.655007858065913,-0.43656949722494104,6,102142,102146,102145,4,-1,3954
CGCCGA,0.914454276649007,-1.1775469722964298,-0.6755338049612971,-0.439248900766266,6,102234,102149,102146,-85,-3,3955
TTCCGC,1.7752275393419599,-1.3469566329226201,-0.6531726450213571,-0.444402533286768,6,101730,102144,102147,414,3,3956
ATTCGA,1.27247099601874,-1.3791576646944699,-0.6535383811233989,-0.44833848850559793,6,102084,102145,102148,61,3,3957
TAGCGA,1.1237711253669,-1.31869654035872,-0.6759266511636071,-0.45575718629548795,6,102168,102150,102149,-18,-1,3958
TCGTAG,1.3639371377331102,-1.09379652416122,-0.6730621641908461,-0.457519448176866,6,102021,102148,102150,127,2,3959
TCGCAT,1.27710895255904,-1.4158022270289998,-0.6790973484563559,-0.460270400413056,6,102081,102151,102151,70,0,3960
TCGCTA,1.11276242584224,-1.3320928820517,-0.685373763464259,-0.461957228813203,6,102174,102154,102152,-20,-2,3961
ATTCGG,1.47002122228678,-1.4092923493884097,-0.6836730658173381,-0.46633241832839006,6,101964,102152,102153,188,1,3962
CCGAAT,1.4717378631832099,-1.4006605774384902,-0.6838419351688361,-0.46639803731659,6,101962,102153,102154,191,1,3963
ATGCGA,1.26885722207026,-1.4163460014323401,-0.688910666169139,-0.4667907891367129,6,102087,102155,102155,68,0,3964
CGACGC,0.6660893075380621,-0.37369331127934097,-0.7260868639595891,-0.46727747789732205,6,102260,102164,102156,-96,-8,3965
GCGTCG,0.663770377320574,-0.0755703121105054,-0.726844206953071,-0.46779372741572106,6,102261,102165,102157,-96,-8,3966
CCGTTA,1.13545843549601,-1.26005645600011,-0.693644511152037,-0.467892625713479,6,102165,102156,102158,-9,2,3967
TTCCGG,1.93095103944498,-1.3887211199083302,-0.694937132007068,-0.475219525782082,6,101635,102157,102159,522,2,3968
TAACGG,1.12518956532103,-1.28381345595517,-0.7050505463373521,-0.475422136852433,6,102167,102159,102160,-8,1,3969
CCGGAA,1.92388931800556,-1.40787194537668,-0.7003837524928149,-0.478761204954301,6,101642,102158,102161,516,3,3970
CCGACT,1.7272190579350302,-1.07048011243164,-0.7065991112768599,-0.47996236874349696,6,101770,102160,102162,390,2,3971
AGTCGG,1.7239374706834798,-1.0798878114247399,-0.7091534821975641,-0.481710036002221,6,101774,102161,102163,387,2,3972
GCGGTT,1.71800293933745,-0.942661117215696,-0.710073322001941,-0.48228796741878205,6,101777,102162,102164,385,2,3973
TAACCG,0.992551062283361,-0.369797390922608,-0.723047473440833,-0.485288080435636,6,102222,102163,102165,-59,2,3974
CCGTAG,1.5342235909733501,-1.1530804921309,-0.732346132160521,-0.49429140853389897,6,101915,102166,102166,251,0,3975
GCGCGT,1.1813042198216799,-0.279685573338746,-0.753651759366315,-0.495380532438604,6,102137,102180,102167,43,-13,3976
CGACTA,0.7790928167036151,-1.4131679672526003,-0.7457268947101701,-0.496728504637084,6,102247,102178,102168,-69,-10,3977
GGTCGT,1.3585518035282902,-1.08791291389995,-0.742133651651177,-0.49796360874325,6,102025,102172,102169,147,-3,3978
ACGACC,1.3606169799566599,-1.09203449575388,-0.7434150735049929,-0.49869032083598597,6,102022,102173,102170,151,-3,3979
CGGTTA,0.971471797815019,-1.1904787751925001,-0.7454179158389209,-0.500023754542118,6,102229,102177,102171,-52,-6,3980
GCGATA,1.0562473152115,-1.23549421211352,-0.743450461319005,-0.500133663029141,6,102202,102174,102172,-28,-2,3981
TCGAAG,1.47203607033963,-1.5512303333896003,-0.7333699715794391,-0.500223369687175,6,101961,102168,102173,207,5,3982
CATCGA,1.50386318569407,-1.2400183341804099,-0.7331419867282529,-0.500538332022055,6,101936,102167,102174,231,7,3983
CTTCGA,1.46922213858597,-1.5644253609195802,-0.73502560941601,-0.5013090642573661,6,101965,102169,102175,204,6,3984
TCGATG,1.49913751544602,-1.24960048109207,-0.7356213268412951,-0.502233393521899,6,101940,102170,102176,230,6,3985
TAGTCG,0.769334423200956,-0.0465181052680492,-0.7550819949059151,-0.502860770433427,6,102248,102182,102177,-66,-5,3986
ACGATT,1.26366036633658,-1.07669910323158,-0.7395884082067191,-0.5072296934281321,6,102093,102171,102178,78,7,3987
ACGGTT,1.4869034504513503,-0.976618030267693,-0.744030235053936,-0.507770997314792,6,101948,102175,102179,227,4,3988
TCGGTC,1.51362670619467,-1.09968316400466,-0.753903901755896,-0.508530429426017,6,101925,102181,102180,256,-1,3989
AATCGT,1.25434615844089,-1.07765830000807,-0.7442648398904801,-0.510292646310632,6,102096,102176,102181,80,5,3990
TATCGC,1.03909580865541,-1.2486310805806398,-0.75904038065109,-0.510320280601439,6,102209,102184,102182,-25,-2,3991
ACGCGC,1.1525234781798899,-0.309927403014797,-0.783893589042366,-0.5145747102135539,6,102159,102191,102183,32,-8,3992
CCGAAA,1.64385436312394,-1.7064920273401498,-0.75273379641245,-0.516151234913181,6,101844,102179,102184,335,5,3993
GACCGA,1.5045236444542598,-1.1150734832171298,-0.7664540609682401,-0.5167532967424601,6,101935,102185,102185,250,0,3994
TTTCGG,1.64043573944334,-1.7009092865135602,-0.755882010798796,-0.518409734208793,6,101848,102183,102186,335,3,3995
AGTCGT,1.2700179722023202,-1.13771565894881,-0.766981329721638,-0.519754286050596,6,102085,102186,102187,101,1,3996
ACGACT,1.26983866633806,-1.1329060180818602,-0.7690250169270791,-0.5210479252269811,6,102086,102187,102188,101,1,3997
CGCGAC,0.57534699238979,-0.6034300914680469,-0.8168291791078609,-0.523581867425189,6,102262,102201,102189,-61,-12,3998
TGTCGG,1.6896363485038102,-1.30977789590355,-0.772807404745501,-0.5244018587029079,6,101804,102188,102190,384,2,3999
GTTCGG,1.3125378312292901,-1.4601768510046398,-0.788147623950177,-0.527982310539009,6,102053,102192,102191,139,-1,4000
CCGACA,1.68727420252802,-1.32999305711028,-0.77930139110422,-0.528601180932636,6,101807,102189,102192,382,3,4001
CCGAAC,1.30993045540526,-1.4686483754508302,-0.794101598056391,-0.5317463161060301,6,102056,102193,102193,137,0,4002
AACCGT,1.4478485441393998,-1.0231968798700601,-0.7803328754018821,-0.531804499454409,6,101972,102190,102194,218,4,4003
CCGACG,0.7668609973679091,-0.602889062516592,-0.823127084242394,-0.531985714045649,6,102249,102205,102195,-44,-10,4004
TACCGC,1.22996830326011,-1.1501046848221599,-0.7977383072563051,-0.5327075025726711,6,102109,102195,102196,86,1,4005
GCGGTA,1.2227354705818898,-1.15663971486315,-0.8046472169105992,-0.5372633327199849,6,102115,102196,102197,81,1,4006
AACCGC,1.6298011748739298,-1.03984791300389,-0.7969839085357149,-0.53957198342643,6,101855,102194,102198,339,4,4007
CGACGG,0.753698039697909,-0.9820511624336421,-0.835966118888468,-0.540020487513046,6,102253,102211,102199,-42,-12,4008
CGTCGG,0.7489772425423449,-0.610982745973121,-0.8391253288200259,-0.5420160910236911,6,102257,102212,102200,-45,-12,4009
CATCGG,1.656056916833,-1.3155095140034798,-0.8086331665513149,-0.5480168447868761,6,101827,102198,102201,371,3,4010
CCGTAC,1.10866785279185,-1.15944781673827,-0.8269574606746991,-0.549805953171796,6,102177,102208,102202,31,-6,4011
TTACGG,1.4228571764317701,-1.16595167704114,-0.8080765090735191,-0.5503452261098771,6,101987,102197,102203,210,6,4012
GTACGG,1.10635989469338,-1.16143185181281,-0.828941495749238,-0.5511654990707929,6,102180,102209,102204,29,-5,4013
CTACGA,1.22264525986218,-1.23439205941516,-0.816218423402953,-0.5521529518936871,6,102116,102200,102205,84,5,4014
CCGTAA,1.41543587926434,-1.1810963842063,-0.8127455402769409,-0.5533149464154039,6,101989,102199,102206,210,7,4015
ATCCGG,1.56074673702867,-1.31362173158653,-0.8225179722853659,-0.55565067048825,6,101899,102204,102207,305,3,4016
CCGGAT,1.5600753707731798,-1.3361844593273302,-0.8231893385408621,-0.556094127741094,6,101900,102206,102208,306,2,4017
CCGTCG,0.726604944787814,-0.21054765475591897,-0.861821549598487,-0.556105511308193,6,102259,102215,102209,-44,-6,4018
CCGATG,1.64254319766627,-1.33576522008174,-0.821786065830962,-0.55668165648856,6,101845,102202,102210,357,8,4019
GTCGCG,0.5191891485094671,-0.659595801348349,-0.8714254357641791,-0.557368647424884,6,102263,102218,102211,-45,-7,4020
ATTCGC,1.1206224162896201,-1.5612031682968501,-0.835583884725779,-0.5633601560523891,6,102170,102210,102212,40,2,4021
GCGACT,1.39466838119032,-1.20521887906369,-0.841337877908915,-0.565146342612842,6,102003,102213,102213,210,0,4022
TTTCGA,1.34632825020607,-1.7673318647888498,-0.8223045890740791,-0.5654473026661191,6,102031,102203,102214,172,11,4023
TCGAAA,1.34202837197168,-1.7787475972825,-0.8249893663547991,-0.5671319773586949,6,102035,102207,102215,172,8,4024
GCGAAC,1.0423187076943399,-1.5384482130491,-0.8639014356546592,-0.5729679867251221,6,102207,102216,102216,9,0,4025
GTTCGC,1.03728725849985,-1.5379394366453503,-0.865910209590892,-0.5742978696188471,6,102210,102217,102217,7,0,4026
AGTCGC,1.3746597104816598,-1.2316775845378503,-0.8609432553106691,-0.577909851427585,6,102017,102214,102218,197,4,4027
CGTCGT,0.28238487375318,-0.681483463805197,-0.909626046652102,-0.5854553561343531,6,102268,102228,102219,-40,-9,4028
TCGGAC,1.2249454162326898,-1.3998736670612602,-0.8772011269810308,-0.585711554304112,6,102113,102219,102220,106,1,4029
GCGTAC,0.847259872231604,-1.2230438871858702,-0.8905535311222931,-0.58636586184913,6,102239,102223,102221,-16,-2,4030
GTACGC,0.839006730474884,-1.23129702894259,-0.898806672879013,-0.591612452542317,6,102241,102226,102222,-15,-4,4031
GTACGA,0.818186677194049,-1.22192015835016,-0.8894298022865871,-0.593337565847337,6,102245,102222,102223,-23,1,4032
TCGACC,1.3833160926387802,-1.23471944780861,-0.886100025559719,-0.59492504983238,6,102010,102220,102224,210,4,4033
GCGAAT,1.07131919057016,-1.6032673399389,-0.886448697669241,-0.5966332637835821,6,102198,102221,102225,23,4,4034
GGTCGA,1.37728848394907,-1.23758297347427,-0.891803711225496,-0.598727655601214,6,102015,102224,102226,209,2,4035
GTCCGA,1.20503010653175,-1.4141339074999197,-0.8975408588956441,-0.598864294463596,6,102123,102225,102227,102,2,4036
TCGTAC,0.79547372599766,-1.2430715223225501,-0.910581166258975,-0.6069506768330379,6,102246,102229,102228,-17,-1,4037
ACGACG,0.23814527394089396,-0.7366502999968509,-0.9568883217226529,-0.61452737096323,6,102270,102244,102229,-26,-15,4038
TACCGA,1.08098073552938,-1.2688953286796298,-0.9165289511137741,-0.617035568799,6,102191,102231,102230,40,-1,4039
TCGGTA,1.07402540995406,-1.27359126439371,-0.9215987664411619,-0.620407528336942,6,102196,102232,102231,36,-1,4040
TCGGAA,1.48547245063596,-1.6167183915363703,-0.9092301986525001,-0.620439880818939,6,101952,102227,102232,275,5,4041
TTCCGA,1.4866485193304,-1.60533872906093,-0.9115547411596608,-0.622051684645324,6,101949,102230,102233,281,3,4042
CCGCGT,1.18351416547249,-0.463826966849684,-0.9492537238281641,-0.62394760487736,6,102134,102242,102234,108,-8,4043
TCGATA,0.8390498106439829,-1.42093320558377,-0.928889454789257,-0.6283736649386551,6,102240,102235,102235,-5,0,4044
CCGGTA,1.28507281420529,-1.2921142813523998,-0.940121783399853,-0.62907824880174,6,102076,102238,102236,162,-2,4045
ACGCGG,1.17518679727423,-0.469195531780594,-0.958718257036756,-0.629940525381797,6,102141,102245,102237,104,-8,4046
TACCGG,1.28330290223883,-1.29425807293217,-0.941891695366312,-0.630221074403301,6,102079,102239,102238,160,-1,4047
TTGCGA,1.26879398184143,-1.53487419411177,-0.931597368535975,-0.6312775643120239,6,102088,102236,102239,148,3,4048
AACCGA,1.4702274122360601,-1.1692247517685102,-0.926360747300329,-0.631723536587214,6,101963,102233,102240,270,7,4049
TCGCAA,1.26367341869612,-1.5454273283954099,-0.93354124350361,-0.632386428826005,6,102092,102237,102241,145,4,4050
TCGGTT,1.4690066238158,-1.1598989216400901,-0.9273111264263292,-0.632550087903638,6,101966,102234,102242,268,8,4051
CGACGT,0.204857890676893,-0.7523671425556501,-0.988714616952395,-0.6341207672676,6,102271,102252,102243,-19,-9,4052
TATCGA,0.8214997989423319,-1.43603016642046,-0.9464394664909079,-0.639868804804959,6,102244,102241,102244,-3,3,4053
ACGTCG,0.18646052553717699,-0.355737588059801,-1.00701148290237,-0.645338552884613,6,102272,102258,102245,-14,-13,4054
AATCGA,1.2231216583506102,-1.2772895400934599,-0.943896079975863,-0.646482279098109,6,102114,102240,102246,126,6,4055
TCGTAA,1.04817807934107,-1.31878376291966,-0.950432918990297,-0.647386746373094,6,102205,102243,102247,38,4,4056
TTACGA,1.03713985951264,-1.32398408299828,-0.966108915030659,-0.657834999197612,6,102211,102246,102248,35,2,4057
TTACGC,1.05061225071697,-1.34070861566721,-0.982833447699594,-0.661037548394456,6,102204,102248,102249,44,1,4058
GCGTAA,1.0432551569178399,-1.3554651964401498,-0.98711435251079,-0.663751620531833,6,102206,102251,102250,45,-1,4059
TCGATT,1.19764505256094,-1.30809848174407,-0.9709877867192049,-0.664608223115181,6,102126,102247,102251,121,4,4060
GATCGG,1.2730893567275,-1.31951410317144,-0.9960028384470669,-0.666233543138323,6,102083,102253,102252,170,-1,4061
TGTCGA,1.2508756772974299,-1.5208536561479398,-0.983883164989893,-0.666305053263098,6,102097,102249,102253,152,4,4062
AACCGG,1.6400992096788,-1.22703786528776,-0.984173860819579,-0.666571048897214,6,101850,102250,102254,400,4,4063
CCGATC,1.2640258976918202,-1.3289014852310501,-1.00539022050667,-0.672186281814989,6,102091,102257,102255,166,-2,4064
TCGGAT,1.1574963006216699,-1.5091931082689198,-0.996197987482454,-0.672543658979078,6,102156,102254,102256,98,2,4065
CCGGTT,1.62507392340197,-1.2334020432638302,-1.00081424805008,-0.6776184128937609,6,101859,102255,102257,396,2,4066
TCGACA,1.23226380147504,-1.55543303695335,-1.00474137094729,-0.6799077214526221,6,102106,102256,102258,150,2,4067
ATCCGA,1.14077528237297,-1.50590827528025,-1.01480451597908,-0.6845938861399411,6,102163,102259,102259,96,0,4068
CGGTCG,0.5136181034600109,-0.429986759497648,-1.07448446790236,-0.6870697060525671,6,102264,102262,102260,-2,-2,4069
CGTTCG,0.0981383885496427,-0.7322366209420469,-1.09387253185564,-0.698442476184407,6,102273,102263,102261,-10,-2,4070
AGTCGA,1.1688706862175,-1.40726968492874,-1.03653535570157,-0.699972741423312,6,102149,102260,102262,111,2,4071
TCGACT,1.1555910141273702,-1.41253773502939,-1.04865673387461,-0.707847248041396,6,102157,102261,102263,104,2,4072
CGACCG,0.460856682790382,-0.516514003636493,-1.12913139881992,-0.7201512343781351,6,102265,102267,102264,2,-3,4073
CGAACG,0.0648735526668567,-0.950504285468332,-1.13016004299669,-0.72036697945225,6,102275,102268,102265,-7,-3,4074
AATCGG,1.2984935004953702,-1.42960260891069,-1.09620914879309,-0.7434913863739809,6,102067,102264,102266,197,2,4075
CCGATA,0.8765911811884929,-1.6129622562491799,-1.12091850545466,-0.749256872432367,6,102236,102265,102267,29,2,4076
TATCGG,0.8627163162868571,-1.6224985600379198,-1.1329078601083702,-0.757041257267362,6,102238,102269,102268,31,-1,4077
CCGATT,1.27710895255904,-1.45820500295588,-1.12109430793102,-0.759840227610167,6,102082,102266,102269,184,3,4078
CGCGTT,0.2943324471743,-0.951621820262636,-1.22506927939091,-0.7888353967409109,6,102267,102270,102270,3,0,4079
CGTACG,-0.26514573856884194,-0.655264312136806,-1.29177259423729,-0.810959556970022,6,102285,102272,102271,-13,-1,4080
AACGCG,0.253183151305434,-1.00680011680715,-1.26460347430611,-0.8127341829913679,6,102269,102271,102272,2,1,4081
TCGTCG,0.05381798886898001,-0.653764189464839,-1.3050380843073999,-0.831622318620529,6,102276,102274,102273,-2,-1,4082
CCGCGA,1.0025615441592701,-0.813186328158004,-1.29861308513648,-0.847403002231794,6,102219,102273,102274,54,1,4083
TCGCGG,0.980474326715322,-0.829292067076343,-1.31881479233251,-0.859991948738785,6,102227,102275,102275,48,0,4084
CGACGA,-0.0428253639228995,-0.8554388130805292,-1.40480461154729,-0.8910617395544029,6,102280,102276,102276,-4,0,4085
ACGCGT,0.301587517135445,-0.76351253977256,-1.43622588621845,-0.925062803624037,6,102266,102277,102277,11,0,4086
TACGCG,-0.273513988239358,-1.27061910803093,-1.4987445077761599,-0.9404987241454741,6,102286,102279,102278,-7,-1,4087
TTCGCG,0.0385969948586258,-1.5237531987399098,-1.48080473170659,-0.9429600375363271,6,102278,102278,102279,0,1,4088
CGCGAA,-0.000265749504103852,-1.55687833001059,-1.51805237511565,-0.9648131221746858,6,102279,102280,102280,1,0,4089
CGATCG,-0.17744015814973604,-1.20895083076575,-1.53785781855013,-0.969552969631708,6,102282,102281,102281,-1,0,4090
CGCGTA,-0.329684259706413,-1.3261594577730902,-1.5534536912089598,-0.972342435978718,6,102287,102282,102282,-5,0,4091
CGTCGA,-0.244526451366106,-1.37680152891959,-1.6049441117665,-1.00855588189555,6,102283,102283,102283,0,0,4092
TCGACG,-0.252723218570285,-1.39290285724487,-1.61314087897068,-1.0133310939657199,6,102284,102284,102284,0,0,4093
ACGCGA,0.0797769581694325,-1.1289026860804598,-1.82644318517957,-1.16489127457023,6,102274,102285,102285,11,0,4094
TCGCGT,0.0507922679524437,-1.1796918536924,-1.85240520013829,-1.18017105945513,6,102277,102286,102286,9,0,4095
TCGCGA,-0.062204894572151,-1.17776790561138,-2.133809102658,-1.3524659504048002,6,102281,102287,102287,6,0,4096
